AAAATAATCTA -> AAATAATCTAG
AAAATCGATCG -> AAATCGATCGC
AAAATTTCCCG -> AAATTTCCCGT
AAACCTAATGA -> AACCTAATGAT
AAACGGGTCGT -> AACGGGTCGTG
AAACTGTCCGG -> AACTGTCCGGT
AAACTTGTGCG -> AACTTGTGCGT
AAACTTTCACC -> AACTTTCACCG
AAAGAAGATAA -> AAGAAGATAAG
AAAGAATGTCG -> AAGAATGTCGC
AAAGAGTGCCT -> AAGAGTGCCTA
AAAGCATTGTC -> AAGCATTGTCG
AAAGCGCCTTC -> AAGCGCCTTCT
AAAGTCACGAT -> AAGTCACGATA
AAAGTGTGAGG -> AAGTGTGAGGA
AAATAATCTAG -> AATAATCTAGT
AAATACTTTCA -> AATACTTTCAA
AAATAGAGGAC -> AATAGAGGACG
AAATAGGTGCT -> AATAGGTGCTT
AAATCGATCGC -> AATCGATCGCT
AAATTTCCCGT -> AATTTCCCGTT
AACAACAGATC -> ACAACAGATCG
AACAAGAACCC -> ACAAGAACCCC
AACACCGCGGA -> ACACCGCGGAA
AACAGATCGAC -> ACAGATCGACA
AACAGATTATT -> ACAGATTATTA
AACAGCCACTT -> ACAGCCACTTC
AACATTTAATC -> ACATTTAATCT
AACCAAGGAAC -> ACCAAGGAACA
AACCACGTTCG -> ACCACGTTCGC
AACCCCTGAGC -> ACCCCTGAGCA
AACCGGGGAGC -> ACCGGGGAGCA
AACCTAATGAT -> ACCTAATGATC
AACGACGGTAG -> ACGACGGTAGG
AACGATTCGAT -> ACGATTCGATT
AACGCCCTAGG -> ACGCCCTAGGG
AACGGACCCCA -> ACGGACCCCAA
AACGGGTCGTG -> ACGGGTCGTGA
AACGGTCTCTG -> ACGGTCTCTGA
AACGGTCTTGG -> ACGGTCTTGGC
AACGTGAGAAA -> ACGTGAGAAAG
AACGTGCAAGG -> ACGTGCAAGGG
AACTATGCCCC -> ACTATGCCCCA
AACTATTGATA -> ACTATTGATAA
AACTGGAATCG -> ACTGGAATCGT
AACTGTCCGGT -> ACTGTCCGGTA
AACTTGCGAAA -> ACTTGCGAAAT
AACTTGTGCGT -> ACTTGTGCGTT
AACTTTCACCG -> ACTTTCACCGC
AACTTTTACGT -> ACTTTTACGTT
AAGAACCCCTG -> AGAACCCCTGA
AAGAAGATAAG -> AGAAGATAAGT
AAGAAGCTTAA -> AGAAGCTTAAA
AAGAATGTCGC -> AGAATGTCGCC
AAGACGTTCAC -> AGACGTTCACG
AAGACTCAGTT -> AGACTCAGTTG
AAGAGTGCCTA -> AGAGTGCCTAA
AAGATAAGTTT -> AGATAAGTTTG
AAGATGTGCGG -> AGATGTGCGGC
AAGATTTGTGC -> AGATTTGTGCG
AAGCAGATACG -> AGCAGATACGC
AAGCATTGTCG -> AGCATTGTCGC
AAGCCACAGGA -> AGCCACAGGAC
AAGCCAGTCAG -> AGCCAGTCAGG
AAGCCATTGAC -> AGCCATTGACA
AAGCGAGGATT -> AGCGAGGATTT
AAGCGCCTTCT -> AGCGCCTTCTA
AAGCTACTGTT -> AGCTACTGTTG
AAGCTTAAAGC -> AGCTTAAAGCG
AAGCTTGTTCC -> AGCTTGTTCCG
AAGGAACAGAT -> AGGAACAGATT
AAGGATTGATC -> AGGATTGATCA
AAGGCTTCGCT -> AGGCTTCGCTC
AAGGGACAACC -> AGGGACAACCA
AAGGGAGCATT -> AGGGAGCATTC
AAGGGTATGCA -> AGGGTATGCAT
AAGGTAGGTGA -> AGGTAGGTGAC
AAGTACACCGT -> AGTACACCGTG
AAGTAGTCTTG -> AGTAGTCTTGA
AAGTATTTGAA -> AGTATTTGAAT
AAGTCACGATA -> AGTCACGATAA
AAGTGAAGATT -> AGTGAAGATTT
AAGTGATCGCG -> AGTGATCGCGC
AAGTGGAAGGG -> AGTGGAAGGGA
AAGTGGCGGGT -> AGTGGCGGGTA
AAGTGTGAGGA -> AGTGTGAGGAG
AAGTTACAAGA -> AGTTACAAGAA
AAGTTGAAGTG -> AGTTGAAGTGG
AAGTTTATATA -> AGTTTATATAA
AAGTTTGACGG -> AGTTTGACGGC
AATAAAATCGA -> ATAAAATCGAT
AATAACCGGGG -> ATAACCGGGGA
AATAATATACA -> ATAATATACAG
AATAATCTAGT -> ATAATCTAGTG
AATACTGAGCT -> ATACTGAGCTA
AATACTTATGT -> ATACTTATGTC
AATACTTTCAA -> ATACTTTCAAA
AATAGAGGACG -> ATAGAGGACGG
AATAGGGGGAG -> ATAGGGGGAGC
AATAGGTGCTT -> ATAGGTGCTTT
AATATACAGTT -> ATATACAGTTG
AATATCATTAC -> ATATCATTACG
AATCATCTACG -> ATCATCTACGT
AATCATGCCTT -> ATCATGCCTTT
AATCCCCGTAT -> ATCCCCGTATC
AATCGATCGCT -> ATCGATCGCTG
AATCGGGAACG -> ATCGGGAACGG
AATCGTGTTCA -> ATCGTGTTCAG
AATCTAGTGCA -> ATCTAGTGCAA
AATCTGAGACG -> ATCTGAGACGT
AATCTGGTCGG -> ATCTGGTCGGA
AATCTTTCTTC -> ATCTTTCTTCT
AATGATCTTGG -> ATGATCTTGGG
AATGATTGCCT -> ATGATTGCCTG
AATGCAGGCCA -> ATGCAGGCCAA
AATGCTTCCCG -> ATGCTTCCCGC
AATGGATATAT -> ATGGATATATT
AATGGCGGTGA -> ATGGCGGTGAC
AATGTCCTCAT -> ATGTCCTCATT
AATGTCGCCGA -> ATGTCGCCGAG
AATTACGCGTT -> ATTACGCGTTG
AATTTCCCGTT -> ATTTCCCGTTA
ACAAACTGTCC -> CAAACTGTCCG
ACAAACTTGTG -> CAAACTTGTGC
ACAACAGATCG -> CAACAGATCGA
ACAACCACGTT -> CAACCACGTTC
ACAACGGTCTC -> CAACGGTCTCT
ACAAGAACCCC -> CAAGAACCCCT
ACAAGAAGCTT -> CAAGAAGCTTA
ACAAGCTACTG -> CAAGCTACTGT
ACAAGCTTGTT -> CAAGCTTGTTC
ACAAGTACACC -> CAAGTACACCG
ACAATAGGGGG -> CAATAGGGGGA
ACACAAGCTTG -> CACAAGCTTGT
ACACCGCGGAA -> CACCGCGGAAC
ACACCGTGTGC -> CACCGTGTGCA
ACACCTACTGG -> CACCTACTGGC
ACACCTCAGCA -> CACCTCAGCAT
ACACGATGCCA -> CACGATGCCAT
ACACTCAGCCA -> CACTCAGCCAC
ACACTGATTTG -> CACTGATTTGG
ACAGAGCAACT -> CAGAGCAACTA
ACAGAGGGCCT -> CAGAGGGCCTA
ACAGATCGACA -> CAGATCGACAG
ACAGATTATTA -> CAGATTATTAA
ACAGCCACTTC -> CAGCCACTTCA
ACAGGACAGAG -> CAGGACAGAGG
ACAGTTGTCCA -> CAGTTGTCCAT
ACATACGAACA -> CATACGAACAG
ACATCCAGTCG -> CATCCAGTCGC
ACATCTGAGGG -> CATCTGAGGGT
ACATGGTCAAA -> CATGGTCAAAG
ACATTTAATCT -> CATTTAATCTT
ACCAACGACGG -> CCAACGACGGT
ACCAAGGAACA -> CCAAGGAACAG
ACCACGTTCGC -> CCACGTTCGCC
ACCAGAGATGA -> CCAGAGATGAA
ACCAGTTTAGA -> CCAGTTTAGAG
ACCCAACACCG -> CCCAACACCGC
ACCCATGCAAT -> CCCATGCAATC
ACCCCAATAAC -> CCCCAATAACC
ACCCCTGAGCA -> CCCCTGAGCAA
ACCCGAAGGCT -> CCCGAAGGCTT
ACCGCGGAACT -> CCGCGGAACTT
ACCGCTAGCGA -> CCGCTAGCGAA
ACCGCTGTGTA -> CCGCTGTGTAA
ACCGGACTATT -> CCGGACTATTT
ACCGGGGAGCA -> CCGGGGAGCAG
ACCGTGTGCAG -> CCGTGTGCAGA
ACCTAATGATC -> CCTAATGATCT
ACCTACTGGCA -> CCTACTGGCAC
ACCTAGCCCAA -> CCTAGCCCAAG
ACCTATTCGCC -> CCTATTCGCCT
ACCTCAGCATC -> CCTCAGCATCA
ACCTGACTCCT -> CCTGACTCCTA
ACCTTATTTGC -> CCTTATTTGCG
ACCTTCGACCG -> CCTTCGACCGG
ACGAACAGCCA -> CGAACAGCCAC
ACGAATGGCGG -> CGAATGGCGGT
ACGACGGTAGG -> CGACGGTAGGA
ACGACTGGAGA -> CGACTGGAGAG
ACGACTTCTCT -> CGACTTCTCTA
ACGATAATCTG -> CGATAATCTGG
ACGATGCACGC -> CGATGCACGCT
ACGATGCCATC -> CGATGCCATCG
ACGATTCGATT -> CGATTCGATTC
ACGCAACGCCC -> CGCAACGCCCT
ACGCCACCAAC -> CGCCACCAACG
ACGCCCTAGGG -> CGCCCTAGGGA
ACGCCTCGCCC -> CGCCTCGCCCA
ACGCGGGGCAT -> CGCGGGGCATG
ACGCGTTGGAG -> CGCGTTGGAGA
ACGCTACCTAG -> CGCTACCTAGC
ACGCTTTGAGA -> CGCTTTGAGAG
ACGGAACTATG -> CGGAACTATGC
ACGGACCCCAA -> CGGACCCCAAT
ACGGCAAGCGA -> CGGCAAGCGAG
ACGGCCACAAC -> CGGCCACAACG
ACGGCCCGACG -> CGGCCCGACGA
ACGGCGCCGTA -> CGGCGCCGTAG
ACGGCTACTGC -> CGGCTACTGCG
ACGGGTCGTGA -> CGGGTCGTGAG
ACGGTAGGACG -> CGGTAGGACGT
ACGGTCTCTGA -> CGGTCTCTGAT
ACGGTCTTGGC -> CGGTCTTGGCT
ACGGTTGATTG -> CGGTTGATTGG
ACGTCATAACG -> CGTCATAACGG
ACGTGAGAAAG -> CGTGAGAAAGT
ACGTGATTAGG -> CGTGATTAGGA
ACGTGCAAGGG -> CGTGCAAGGGT
ACGTTAACTGG -> CGTTAACTGGA
ACGTTCACGAC -> CGTTCACGACT
ACGTTCATCGC -> CGTTCATCGCC
ACGTTCGCCCT -> CGTTCGCCCTG
ACGTTCTAAAC -> CGTTCTAAACT
ACTACCTTCGA -> CTACCTTCGAC
ACTACGTCATA -> CTACGTCATAA
ACTATGCCCCA -> CTATGCCCCAG
ACTATTGATAA -> CTATTGATAAG
ACTATTTTATG -> CTATTTTATGG
ACTCAGCCACG -> CTCAGCCACGC
ACTCAGTTGGC -> CTCAGTTGGCC
ACTCCTAAAGA -> CTCCTAAAGAG
ACTCCTCGAGT -> CTCCTCGAGTT
ACTCTAATACT -> CTCTAATACTG
ACTCTCAAACG -> CTCTCAAACGG
ACTGAGCTATC -> CTGAGCTATCG
ACTGATTTGGA -> CTGATTTGGAA
ACTGCGCTGTT -> CTGCGCTGTTA
ACTGGAATCGT -> CTGGAATCGTG
ACTGGAGAGTA -> CTGGAGAGTAC
ACTGGCACTAC -> CTGGCACTACC
ACTGTCCGGTA -> CTGTCCGGTAA
ACTGTTGACTT -> CTGTTGACTTA
ACTTACTCCTC -> CTTACTCCTCG
ACTTATCAGCT -> CTTATCAGCTA
ACTTATGTCTA -> CTTATGTCTAG
ACTTCAGCCTT -> CTTCAGCCTTA
ACTTCTCTAAG -> CTTCTCTAAGC
ACTTGCGAAAT -> CTTGCGAAATA
ACTTGTGCGTT -> CTTGTGCGTTG
ACTTTCAAAGA -> CTTTCAAAGAA
ACTTTCACCGC -> CTTTCACCGCT
ACTTTTACGTT -> CTTTTACGTTC
AGAAAGTGTGA -> GAAAGTGTGAG
AGAACAAGAAC -> GAACAAGAACC
AGAACCCCTGA -> GAACCCCTGAG
AGAACGTGAGA -> GAACGTGAGAA
AGAACGTGCAA -> GAACGTGCAAG
AGAAGACGTTC -> GAAGACGTTCA
AGAAGATAAGT -> GAAGATAAGTT
AGAAGCTTAAA -> GAAGCTTAAAG
AGAAGGGACAA -> GAAGGGACAAC
AGAATATCATT -> GAATATCATTA
AGAATGTCCTC -> GAATGTCCTCA
AGAATGTCGCC -> GAATGTCGCCG
AGACGTGATTA -> GACGTGATTAG
AGACGTTCACG -> GACGTTCACGA
AGACTCAGTTG -> GACTCAGTTGG
AGAGATGAAGT -> GAGATGAAGTG
AGAGCAACTAT -> GAGCAACTATT
AGAGGACGGCA -> GAGGACGGCAA
AGAGGATTGTA -> GAGGATTGTAC
AGAGGCCAGTC -> GAGGCCAGTCG
AGAGGGCCTAC -> GAGGGCCTACC
AGAGTACTACG -> GAGTACTACGT
AGAGTCTCTCT -> GAGTCTCTCTT
AGAGTGCCTAA -> GAGTGCCTAAT
AGATAAGTTTG -> GATAAGTTTGA
AGATACGCGGG -> GATACGCGGGG
AGATAGCGGTG -> GATAGCGGTGT
AGATCAGGAAT -> GATCAGGAATG
AGATCGACAGA -> GATCGACAGAG
AGATGAAGTGA -> GATGAAGTGAA
AGATGTAAACC -> GATGTAAACCT
AGATGTGCGGC -> GATGTGCGGCT
AGATGTGCTGC -> GATGTGCTGCA
AGATTATTAAC -> GATTATTAACA
AGATTTGTGCG -> GATTTGTGCGG
AGCAAATAGGT -> GCAAATAGGTG
AGCAACGATTC -> GCAACGATTCG
AGCAACTATTG -> GCAACTATTGA
AGCAATAAAAT -> GCAATAAAATC
AGCACAAACTT -> GCACAAACTTG
AGCACACCTAC -> GCACACCTACT
AGCACCCATGC -> GCACCCATGCA
AGCAGAACAAG -> GCAGAACAAGA
AGCAGATACGC -> GCAGATACGCG
AGCAGATAGCG -> GCAGATAGCGG
AGCATATCTGC -> GCATATCTGCC
AGCATCAAGTT -> GCATCAAGTTT
AGCATTCTTTA -> GCATTCTTTAA
AGCATTGTCGC -> GCATTGTCGCA
AGCCACAGGAC -> GCCACAGGACA
AGCCACGCCAC -> GCCACGCCACC
AGCCACTTCAG -> GCCACTTCAGC
AGCCAGTCAGG -> GCCAGTCAGGA
AGCCATTGACA -> GCCATTGACAT
AGCCCAAGTGA -> GCCCAAGTGAT
AGCCCATCCAG -> GCCCATCCAGT
AGCCCTATTTA -> GCCCTATTTAG
AGCCTTACATC -> GCCTTACATCT
AGCCTTACTCT -> GCCTTACTCTC
AGCGAAGTGGA -> GCGAAGTGGAA
AGCGAGGATTT -> GCGAGGATTTG
AGCGCCTTCTA -> GCGCCTTCTAC
AGCGCTTCGCT -> GCGCTTCGCTA
AGCGGACACAA -> GCGGACACAAG
AGCGGTGTTGT -> GCGGTGTTGTG
AGCGTCAGTGT -> GCGTCAGTGTT
AGCTAAGTAGT -> GCTAAGTAGTC
AGCTACTGTTG -> GCTACTGTTGA
AGCTATCGCCA -> GCTATCGCCAG
AGCTCACGCCT -> GCTCACGCCTC
AGCTCGATTAT -> GCTCGATTATG
AGCTCTGGGTG -> GCTCTGGGTGG
AGCTGAGCCTT -> GCTGAGCCTTA
AGCTTAAAGCG -> GCTTAAAGCGC
AGCTTCAAGCC -> GCTTCAAGCCA
AGCTTGTTCCG -> GCTTGTTCCGG
AGCTTTTACGG -> GCTTTTACGGC
AGGAACAGATT -> GGAACAGATTA
AGGAATGATTG -> GGAATGATTGC
AGGACAGAGGG -> GGACAGAGGGC
AGGACATGGTC -> GGACATGGTCA
AGGACGGCAAG -> GGACGGCAAGC
AGGACGTTCTA -> GGACGTTCTAA
AGGAGCACACC -> GGAGCACACCT
AGGATCCCCAG -> GGATCCCCAGG
AGGATTGATCA -> GGATTGATCAA
AGGATTGTACG -> GGATTGTACGG
AGGATTTGGGG -> GGATTTGGGGA
AGGCCAATCGG -> GGCCAATCGGG
AGGCCACCTTA -> GGCCACCTTAT
AGGCCAGTCGG -> GGCCAGTCGGC
AGGCCTTAATA -> GGCCTTAATAC
AGGCTTCGCTC -> GGCTTCGCTCA
AGGGACAACCA -> GGGACAACCAC
AGGGAGCATTC -> GGGAGCATTCT
AGGGAGTCGAT -> GGGAGTCGATG
AGGGCCTACCG -> GGGCCTACCGC
AGGGGGAGCTC -> GGGGGAGCTCG
AGGGGGGCATT -> GGGGGGCATTA
AGGGTAGAATA -> GGGTAGAATAT
AGGGTATGCAT -> GGGTATGCATA
AGGTAGGTGAC -> GGTAGGTGACT
AGGTCAAAATT -> GGTCAAAATTT
AGGTGACTCTA -> GGTGACTCTAA
AGGTGCTTTCG -> GGTGCTTTCGG
AGGTTACCAGA -> GGTTACCAGAG
AGTACACCGTG -> GTACACCGTGT
AGTACATCCAG -> GTACATCCAGT
AGTACGCAACG -> GTACGCAACGC
AGTACTACGTC -> GTACTACGTCA
AGTAGTCTTGA -> GTAGTCTTGAA
AGTATGCCAAA -> GTATGCCAAAG
AGTATTTCGGA -> GTATTTCGGAG
AGTATTTGAAT -> GTATTTGAATA
AGTCACGATAA -> GTCACGATAAT
AGTCAGGACAT -> GTCAGGACATG
AGTCGATGGAC -> GTCGATGGACA
AGTCGCACCGC -> GTCGCACCGCT
AGTCGGCTGAC -> GTCGGCTGACC
AGTCTCTCTTA -> GTCTCTCTTAA
AGTCTTGAATT -> GTCTTGAATTA
AGTGAAGATTT -> GTGAAGATTTG
AGTGAGCTTTT -> GTGAGCTTTTA
AGTGATCGCGC -> GTGATCGCGCT
AGTGCAACTTG -> GTGCAACTTGC
AGTGCCTAATC -> GTGCCTAATCT
AGTGGAAGGGA -> GTGGAAGGGAG
AGTGGCGGGTA -> GTGGCGGGTAG
AGTGTGAGAAG -> GTGTGAGAAGG
AGTGTGAGGAG -> GTGTGAGGAGC
AGTGTTATAAG -> GTGTTATAAGT
AGTTACAAACT -> GTTACAAACTG
AGTTACAAGAA -> GTTACAAGAAG
AGTTAGCTTCA -> GTTAGCTTCAA
AGTTGAAGTGG -> GTTGAAGTGGC
AGTTGCTATGT -> GTTGCTATGTA
AGTTGGCCCTA -> GTTGGCCCTAG
AGTTGTCCATG -> GTTGTCCATGA
AGTTTACCTGA -> GTTTACCTGAC
AGTTTAGAGTC -> GTTTAGAGTCT
AGTTTATATAA -> GTTTATATAAG
AGTTTGACGGC -> GTTTGACGGCC
ATAAAATCGAT -> TAAAATCGATC
ATAAAGAAGAT -> TAAAGAAGATA
ATAACCGGGGA -> TAACCGGGGAG
ATAACGGACCC -> TAACGGACCCC
ATAAGACTCAG -> TAAGACTCAGT
ATAAGCCATTG -> TAAGCCATTGA
ATAAGTATTTG -> TAAGTATTTGA
ATAAGTTTGAC -> TAAGTTTGACG
ATAATATACAG -> TAATATACAGT
ATAATCTAGTG -> TAATCTAGTGC
ATAATCTGGTC -> TAATCTGGTCG
ATACAGTTGTC -> TACAGTTGTCC
ATACGAACAGC -> TACGAACAGCC
ATACGCGGGGC -> TACGCGGGGCA
ATACTGAGCTA -> TACTGAGCTAT
ATACTTATGTC -> TACTTATGTCT
ATACTTTCAAA -> TACTTTCAAAG
ATAGAGGACGG -> TAGAGGACGGC
ATAGCGGTGTT -> TAGCGGTGTTG
ATAGCGTCAGT -> TAGCGTCAGTG
ATAGGGGGAGC -> TAGGGGGAGCT
ATAGGTGCTTT -> TAGGTGCTTTC
ATATAAGCCAT -> TATAAGCCATT
ATATACAGTTG -> TATACAGTTGT
ATATAGCGTCA -> TATAGCGTCAG
ATATATTTCCA -> TATATTTCCAA
ATATCATTACG -> TATCATTACGC
ATATCTGCCTC -> TATCTGCCTCA
ATATTTCCAAA -> TATTTCCAAAT
ATCAACATTTA -> TCAACATTTAA
ATCAAGTTTAT -> TCAAGTTTATA
ATCACCTATTC -> TCACCTATTCG
ATCAGCTAAGT -> TCAGCTAAGTA
ATCAGGAATGA -> TCAGGAATGAT
ATCATCTACGT -> TCATCTACGTT
ATCATGCCTTT -> TCATGCCTTTG
ATCATTACGCT -> TCATTACGCTA
ATCCAGTACAT -> TCCAGTACATC
ATCCAGTCGCA -> TCCAGTCGCAC
ATCCCCAGGCC -> TCCCCAGGCCT
ATCCCCGTATC -> TCCCCGTATCT
ATCCTTCTGAG -> TCCTTCTGAGC
ATCGACAGAGC -> TCGACAGAGCA
ATCGATCGCTG -> TCGATCGCTGC
ATCGCCAGTAT -> TCGCCAGTATG
ATCGCCGACAC -> TCGCCGACACG
ATCGCGCTCAT -> TCGCGCTCATT
ATCGCTGCCGG -> TCGCTGCCGGC
ATCGGGAACGG -> TCGGGAACGGT
ATCGTAAGTTG -> TCGTAAGTTGA
ATCGTGTTCAG -> TCGTGTTCAGT
ATCTACGTTAA -> TCTACGTTAAC
ATCTAGTGCAA -> TCTAGTGCAAC
ATCTGAGACGT -> TCTGAGACGTG
ATCTGAGGGTA -> TCTGAGGGTAG
ATCTGCCTCAT -> TCTGCCTCATT
ATCTGGTCGGA -> TCTGGTCGGAG
ATCTTCTGGCT -> TCTTCTGGCTC
ATCTTGGGTGC -> TCTTGGGTGCC
ATCTTTCTTCT -> TCTTTCTTCTC
ATGAAGTGAAG -> TGAAGTGAAGA
ATGAATGGATA -> TGAATGGATAT
ATGAGCACAAA -> TGAGCACAAAC
ATGATCTTGGG -> TGATCTTGGGT
ATGATTGCCTG -> TGATTGCCTGA
ATGCAATCATG -> TGCAATCATGC
ATGCACGCTTT -> TGCACGCTTTG
ATGCAGGCCAA -> TGCAGGCCAAT
ATGCATAAAGA -> TGCATAAAGAA
ATGCCAAAGCA -> TGCCAAAGCAT
ATGCCATCGTA -> TGCCATCGTAA
ATGCCCCAGCT -> TGCCCCAGCTC
ATGCCTTTGGG -> TGCCTTTGGGG
ATGCTAGGCCA -> TGCTAGGCCAC
ATGCTTCCCGC -> TGCTTCCCGCG
ATGGACACTCA -> TGGACACTCAG
ATGGATATATT -> TGGATATATTT
ATGGCGGTGAC -> TGGCGGTGACG
ATGGCGTAGTA -> TGGCGTAGTAC
ATGGTCAAAGT -> TGGTCAAAGTC
ATGTAAACCTA -> TGTAAACCTAA
ATGTAGTGTGA -> TGTAGTGTGAG
ATGTCCTCATT -> TGTCCTCATTG
ATGTCGCCGAG -> TGTCGCCGAGC
ATGTCTAGCTG -> TGTCTAGCTGA
ATGTGAGTTAG -> TGTGAGTTAGC
ATGTGCGCACG -> TGTGCGCACGG
ATGTGCGGCTA -> TGTGCGGCTAG
ATGTGCTGCAG -> TGTGCTGCAGA
ATTAACAACAG -> TTAACAACAGA
ATTACACCTCA -> TTACACCTCAG
ATTACGCGTTG -> TTACGCGTTGG
ATTACGCTACC -> TTACGCTACCT
ATTAGGATCCC -> TTAGGATCCCC
ATTATGAATGG -> TTATGAATGGA
ATTATTAACAA -> TTATTAACAAC
ATTCATCACCT -> TTCATCACCTA
ATTCGATTCAT -> TTCGATTCATC
ATTCGCCTTGC -> TTCGCCTTGCA
ATTCTTTAATC -> TTCTTTAATCC
ATTGACATACG -> TTGACATACGA
ATTGAGTTACA -> TTGAGTTACAA
ATTGATAAGAC -> TTGATAAGACT
ATTGATCAACA -> TTGATCAACAT
ATTGCCTGAGC -> TTGCCTGAGCA
ATTGGTATATA -> TTGGTATATAG
ATTGTACGGCG -> TTGTACGGCGC
ATTGTCGCACG -> TTGTCGCACGG
ATTGTTAAGGT -> TTGTTAAGGTA
ATTGTTAGGTT -> TTGTTAGGTTA
ATTTAATCTTT -> TTTAATCTTTC
ATTTAGAAGAC -> TTTAGAAGACG
ATTTCCAAATA -> TTTCCAAATAG
ATTTCCCGTTA -> TTTCCCGTTAG
ATTTCGGAGAT -> TTTCGGAGATG
ATTTGAATAAT -> TTTGAATAATA
ATTTGCGACAA -> TTTGCGACAAT
ATTTGGAAGCC -> TTTGGAAGCCA
ATTTGGGGACA -> TTTGGGGACAC
ATTTGGTTACA -> TTTGGTTACAA
ATTTGTGCGGA -> TTTGTGCGGAT
ATTTTATGGCG -> TTTTATGGCGT
CAAAATTTCCC -> AAAATTTCCCG
CAAACGGGTCG -> AAACGGGTCGT
CAAACTGTCCG -> AAACTGTCCGG
CAAACTTGTGC -> AAACTTGTGCG
CAAAGAATGTC -> AAAGAATGTCG
CAAAGCATTGT -> AAAGCATTGTC
CAAAGTCACGA -> AAAGTCACGAT
CAAATAGAGGA -> AAATAGAGGAC
CAAATAGGTGC -> AAATAGGTGCT
CAACACCGCGG -> AACACCGCGGA
CAACAGATCGA -> AACAGATCGAC
CAACATTTAAT -> AACATTTAATC
CAACCACGTTC -> AACCACGTTCG
CAACGACGGTA -> AACGACGGTAG
CAACGATTCGA -> AACGATTCGAT
CAACGCCCTAG -> AACGCCCTAGG
CAACGGTCTCT -> AACGGTCTCTG
CAACTATTGAT -> AACTATTGATA
CAACTTGCGAA -> AACTTGCGAAA
CAAGAACCCCT -> AAGAACCCCTG
CAAGAAGCTTA -> AAGAAGCTTAA
CAAGATGTGCG -> AAGATGTGCGG
CAAGCCACAGG -> AAGCCACAGGA
CAAGCGAGGAT -> AAGCGAGGATT
CAAGCTACTGT -> AAGCTACTGTT
CAAGCTTGTTC -> AAGCTTGTTCC
CAAGGAACAGA -> AAGGAACAGAT
CAAGGGTATGC -> AAGGGTATGCA
CAAGTACACCG -> AAGTACACCGT
CAAGTGATCGC -> AAGTGATCGCG
CAAGTTACAAG -> AAGTTACAAGA
CAAGTTTATAT -> AAGTTTATATA
CAATAAAATCG -> AATAAAATCGA
CAATAACCGGG -> AATAACCGGGG
CAATAGGGGGA -> AATAGGGGGAG
CAATCATGCCT -> AATCATGCCTT
CAATCGGGAAC -> AATCGGGAACG
CACAAACTTGT -> ACAAACTTGTG
CACAACGGTCT -> ACAACGGTCTC
CACAAGCTTGT -> ACAAGCTTGTT
CACACCTACTG -> ACACCTACTGG
CACAGGACAGA -> ACAGGACAGAG
CACCAACGACG -> ACCAACGACGG
CACCAGTTTAG -> ACCAGTTTAGA
CACCCATGCAA -> ACCCATGCAAT
CACCGCGGAAC -> ACCGCGGAACT
CACCGCTAGCG -> ACCGCTAGCGA
CACCGCTGTGT -> ACCGCTGTGTA
CACCGTGTGCA -> ACCGTGTGCAG
CACCTACTGGC -> ACCTACTGGCA
CACCTATTCGC -> ACCTATTCGCC
CACCTCAGCAT -> ACCTCAGCATC
CACCTTATTTG -> ACCTTATTTGC
CACGACTTCTC -> ACGACTTCTCT
CACGATAATCT -> ACGATAATCTG
CACGATGCCAT -> ACGATGCCATC
CACGCCACCAA -> ACGCCACCAAC
CACGCCTCGCC -> ACGCCTCGCCC
CACGCTTTGAG -> ACGCTTTGAGA
CACGGAACTAT -> ACGGAACTATG
CACGGCTACTG -> ACGGCTACTGC
CACGGTTGATT -> ACGGTTGATTG
CACGTTCGCCC -> ACGTTCGCCCT
CACTACCTTCG -> ACTACCTTCGA
CACTCAGCCAC -> ACTCAGCCACG
CACTGATTTGG -> ACTGATTTGGA
CACTTCAGCCT -> ACTTCAGCCTT
CAGAACAAGAA -> AGAACAAGAAC
CAGAACGTGAG -> AGAACGTGAGA
CAGAACGTGCA -> AGAACGTGCAA
CAGAGATGAAG -> AGAGATGAAGT
CAGAGCAACTA -> AGAGCAACTAT
CAGAGGGCCTA -> AGAGGGCCTAC
CAGATACGCGG -> AGATACGCGGG
CAGATAGCGGT -> AGATAGCGGTG
CAGATCGACAG -> AGATCGACAGA
CAGATTATTAA -> AGATTATTAAC
CAGCAAATAGG -> AGCAAATAGGT
CAGCATCAAGT -> AGCATCAAGTT
CAGCCACGCCA -> AGCCACGCCAC
CAGCCACTTCA -> AGCCACTTCAG
CAGCCTTACTC -> AGCCTTACTCT
CAGCTAAGTAG -> AGCTAAGTAGT
CAGCTCTGGGT -> AGCTCTGGGTG
CAGGAATGATT -> AGGAATGATTG
CAGGACAGAGG -> AGGACAGAGGG
CAGGACATGGT -> AGGACATGGTC
CAGGCCAATCG -> AGGCCAATCGG
CAGGCCTTAAT -> AGGCCTTAATA
CAGTACATCCA -> AGTACATCCAG
CAGTATGCCAA -> AGTATGCCAAA
CAGTATTTCGG -> AGTATTTCGGA
CAGTCAGGACA -> AGTCAGGACAT
CAGTCGCACCG -> AGTCGCACCGC
CAGTCGGCTGA -> AGTCGGCTGAC
CAGTGTTATAA -> AGTGTTATAAG
CAGTTGGCCCT -> AGTTGGCCCTA
CAGTTGTCCAT -> AGTTGTCCATG
CAGTTTACCTG -> AGTTTACCTGA
CAGTTTAGAGT -> AGTTTAGAGTC
CATAAAGAAGA -> ATAAAGAAGAT
CATAACGGACC -> ATAACGGACCC
CATACGAACAG -> ATACGAACAGC
CATATCTGCCT -> ATATCTGCCTC
CATCAAGTTTA -> ATCAAGTTTAT
CATCACCTATT -> ATCACCTATTC
CATCCAGTACA -> ATCCAGTACAT
CATCCAGTCGC -> ATCCAGTCGCA
CATCCTTCTGA -> ATCCTTCTGAG
CATCGCCGACA -> ATCGCCGACAC
CATCGTAAGTT -> ATCGTAAGTTG
CATCTACGTTA -> ATCTACGTTAA
CATCTGAGGGT -> ATCTGAGGGTA
CATGAGCACAA -> ATGAGCACAAA
CATGCAATCAT -> ATGCAATCATG
CATGCCTTTGG -> ATGCCTTTGGG
CATGGTCAAAG -> ATGGTCAAAGT
CATGTGCGCAC -> ATGTGCGCACG
CATTACACCTC -> ATTACACCTCA
CATTACGCTAC -> ATTACGCTACC
CATTCTTTAAT -> ATTCTTTAATC
CATTGACATAC -> ATTGACATACG
CATTGAGTTAC -> ATTGAGTTACA
CATTGTCGCAC -> ATTGTCGCACG
CATTGTTAGGT -> ATTGTTAGGTT
CATTTAATCTT -> ATTTAATCTTT
CATTTGGTTAC -> ATTTGGTTACA
CCAAAGCATTG -> CAAAGCATTGT
CCAAATAGAGG -> CAAATAGAGGA
CCAACACCGCG -> CAACACCGCGG
CCAACGACGGT -> CAACGACGGTA
CCAAGATGTGC -> CAAGATGTGCG
CCAAGGAACAG -> CAAGGAACAGA
CCAAGTGATCG -> CAAGTGATCGC
CCAATAACCGG -> CAATAACCGGG
CCAATCGGGAA -> CAATCGGGAAC
CCACAACGGTC -> CACAACGGTCT
CCACAGGACAG -> CACAGGACAGA
CCACCAACGAC -> CACCAACGACG
CCACCTTATTT -> CACCTTATTTG
CCACGCCACCA -> CACGCCACCAA
CCACGTTCGCC -> CACGTTCGCCC
CCACTTCAGCC -> CACTTCAGCCT
CCAGAGATGAA -> CAGAGATGAAG
CCAGCAAATAG -> CAGCAAATAGG
CCAGCTCTGGG -> CAGCTCTGGGT
CCAGGCCTTAA -> CAGGCCTTAAT
CCAGTACATCC -> CAGTACATCCA
CCAGTATGCCA -> CAGTATGCCAA
CCAGTCAGGAC -> CAGTCAGGACA
CCAGTCGCACC -> CAGTCGCACCG
CCAGTCGGCTG -> CAGTCGGCTGA
CCAGTTTAGAG -> CAGTTTAGAGT
CCATCCAGTAC -> CATCCAGTACA
CCATCGTAAGT -> CATCGTAAGTT
CCATGAGCACA -> CATGAGCACAA
CCATGCAATCA -> CATGCAATCAT
CCATTGACATA -> CATTGACATAC
CCCAACACCGC -> CCAACACCGCG
CCCAAGATGTG -> CCAAGATGTGC
CCCAAGTGATC -> CCAAGTGATCG
CCCAATAACCG -> CCAATAACCGG
CCCAGCAAATA -> CCAGCAAATAG
CCCAGCTCTGG -> CCAGCTCTGGG
CCCAGGCCTTA -> CCAGGCCTTAA
CCCATCCAGTA -> CCATCCAGTAC
CCCATGCAATC -> CCATGCAATCA
CCCCAATAACC -> CCCAATAACCG
CCCCAGCTCTG -> CCCAGCTCTGG
CCCCAGGCCTT -> CCCAGGCCTTA
CCCCGTATCTT -> CCCGTATCTTC
CCCCTGAGCAA -> CCCTGAGCAAT
CCCGAAGGCTT -> CCGAAGGCTTC
CCCGACGAATG -> CCGACGAATGG
CCCGCGCACGG -> CCGCGCACGGT
CCCGTATCTTC -> CCGTATCTTCT
CCCGTTAGCCC -> CCGTTAGCCCT
CCCTAGAATGT -> CCTAGAATGTC
CCCTAGCAGAT -> CCTAGCAGATA
CCCTAGGGAGT -> CCTAGGGAGTC
CCCTATTTAGA -> CCTATTTAGAA
CCCTGAGCAAT -> CCTGAGCAATA
CCCTGGGACGA -> CCTGGGACGAC
CCGAAGGCTTC -> CGAAGGCTTCG
CCGACACGATG -> CGACACGATGC
CCGACGAATGG -> CGACGAATGGC
CCGAGCCCATC -> CGAGCCCATCC
CCGCGCACGGT -> CGCGCACGGTT
CCGCGGAACTT -> CGCGGAACTTT
CCGCTAGCGAA -> CGCTAGCGAAG
CCGCTGTGTAA -> CGCTGTGTAAT
CCGGAATCATC -> CGGAATCATCT
CCGGACTATTT -> CGGACTATTTT
CCGGCATCCTT -> CGGCATCCTTC
CCGGGGAGCAG -> CGGGGAGCAGA
CCGGTAACCAA -> CGGTAACCAAG
CCGTAGTGAGC -> CGTAGTGAGCT
CCGTATCTTCT -> CGTATCTTCTG
CCGTGTGCAGA -> CGTGTGCAGAA
CCGTTAGCCCT -> CGTTAGCCCTA
CCTAAAGAGTG -> CTAAAGAGTGC
CCTAATCTGAG -> CTAATCTGAGA
CCTAATGATCT -> CTAATGATCTT
CCTACCGCCAG -> CTACCGCCAGA
CCTACTGGCAC -> CTACTGGCACT
CCTAGAATGTC -> CTAGAATGTCC
CCTAGCAGATA -> CTAGCAGATAG
CCTAGCCCAAG -> CTAGCCCAAGT
CCTAGGGAGTC -> CTAGGGAGTCG
CCTATTCGCCT -> CTATTCGCCTT
CCTATTTAGAA -> CTATTTAGAAG
CCTCAGCATCA -> CTCAGCATCAA
CCTCATTGTTA -> CTCATTGTTAG
CCTCATTTGGT -> CTCATTTGGTT
CCTCGAGTTGC -> CTCGAGTTGCT
CCTCGCCCAAG -> CTCGCCCAAGA
CCTGACTCCTA -> CTGACTCCTAA
CCTGAGATCAG -> CTGAGATCAGG
CCTGAGCAACG -> CTGAGCAACGA
CCTGAGCAATA -> CTGAGCAATAA
CCTGGGACGAC -> CTGGGACGACT
CCTTAATACTT -> CTTAATACTTA
CCTTACATCTG -> CTTACATCTGA
CCTTACTCTCA -> CTTACTCTCAA
CCTTATTTGCG -> CTTATTTGCGA
CCTTCGACCGG -> CTTCGACCGGA
CCTTCTACTTA -> CTTCTACTTAT
CCTTCTGAGCT -> CTTCTGAGCTC
CCTTGCAAGTT -> CTTGCAAGTTA
CCTTTGGGGCT -> CTTTGGGGCTC
CGAAATACTTT -> GAAATACTTTC
CGAACAGCCAC -> GAACAGCCACT
CGAAGGCTTCG -> GAAGGCTTCGC
CGAAGTGGAAG -> GAAGTGGAAGG
CGAATGGCGGT -> GAATGGCGGTG
CGACAATAGGG -> GACAATAGGGG
CGACACGATGC -> GACACGATGCC
CGACAGAGCAA -> GACAGAGCAAC
CGACCGGACTA -> GACCGGACTAT
CGACGAATGGC -> GACGAATGGCG
CGACGGTAGGA -> GACGGTAGGAC
CGACTGGAGAG -> GACTGGAGAGT
CGACTTCTCTA -> GACTTCTCTAA
CGAGCCCATCC -> GAGCCCATCCA
CGAGGATTTGG -> GAGGATTTGGG
CGAGTTGCTAT -> GAGTTGCTATG
CGATAATCTGG -> GATAATCTGGT
CGATCGCTGCC -> GATCGCTGCCG
CGATGCACGCT -> GATGCACGCTT
CGATGCCATCG -> GATGCCATCGT
CGATGGACACT -> GATGGACACTC
CGATGTGAGTT -> GATGTGAGTTA
CGATTATGAAT -> GATTATGAATG
CGATTCATCAC -> GATTCATCACC
CGATTCGATTC -> GATTCGATTCA
CGCAACGCCCT -> GCAACGCCCTA
CGCACCGCTAG -> GCACCGCTAGC
CGCACGGAACT -> GCACGGAACTA
CGCACGGCTAC -> GCACGGCTACT
CGCACGGTTGA -> GCACGGTTGAT
CGCCACCAACG -> GCCACCAACGA
CGCCAGTATGC -> GCCAGTATGCC
CGCCCAAGATG -> GCCCAAGATGT
CGCCCTAGGGA -> GCCCTAGGGAG
CGCCCTGGGAC -> GCCCTGGGACG
CGCCGACACGA -> GCCGACACGAT
CGCCGAGCCCA -> GCCGAGCCCAT
CGCCGTAGTGA -> GCCGTAGTGAG
CGCCTCGCCCA -> GCCTCGCCCAA
CGCCTTCTACT -> GCCTTCTACTT
CGCCTTGCAAG -> GCCTTGCAAGT
CGCGCACGGTT -> GCGCACGGTTG
CGCGCTCATTG -> GCGCTCATTGA
CGCGGAACTTT -> GCGGAACTTTT
CGCGGGGCATG -> GCGGGGCATGT
CGCGTTGGAGA -> GCGTTGGAGAT
CGCTAATGCAG -> GCTAATGCAGG
CGCTACCTAGC -> GCTACCTAGCC
CGCTAGCGAAG -> GCTAGCGAAGT
CGCTCACCAGT -> GCTCACCAGTT
CGCTCATTGAG -> GCTCATTGAGT
CGCTGCCGGCA -> GCTGCCGGCAT
CGCTGTGTAAT -> GCTGTGTAATG
CGCTGTTACAA -> GCTGTTACAAG
CGCTTCGCTAA -> GCTTCGCTAAT
CGCTTTGAGAG -> GCTTTGAGAGG
CGGAACTATGC -> GGAACTATGCC
CGGAACTTTTA -> GGAACTTTTAC
CGGAATCATCT -> GGAATCATCTA
CGGACACAAGC -> GGACACAAGCT
CGGACCCCAAT -> GGACCCCAATA
CGGACTATTTT -> GGACTATTTTA
CGGAGATGTAA -> GGAGATGTAAA
CGGAGGGGGGC -> GGAGGGGGGCA
CGGATGCTAGG -> GGATGCTAGGC
CGGCAAGCGAG -> GGCAAGCGAGG
CGGCATCCTTC -> GGCATCCTTCT
CGGCCACAACG -> GGCCACAACGG
CGGCCCGACGA -> GGCCCGACGAA
CGGCGCCGTAG -> GGCGCCGTAGT
CGGCTACTGCG -> GGCTACTGCGC
CGGCTAGCGCT -> GGCTAGCGCTT
CGGCTGACCCG -> GGCTGACCCGA
CGGGAACGGTC -> GGGAACGGTCT
CGGGAGCACCC -> GGGAGCACCCA
CGGGGAGCAGA -> GGGGAGCAGAA
CGGGGCATGTG -> GGGGCATGTGC
CGGGTAGCGGA -> GGGTAGCGGAC
CGGGTCGTGAG -> GGGTCGTGAGA
CGGTAACCAAG -> GGTAACCAAGG
CGGTAGGACGT -> GGTAGGACGTT
CGGTCTCTGAT -> GGTCTCTGATT
CGGTCTTGGCT -> GGTCTTGGCTT
CGGTGACGATG -> GGTGACGATGC
CGGTGTTGTGA -> GGTGTTGTGAG
CGGTTGATTGG -> GGTTGATTGGT
CGTAAGTTGAA -> GTAAGTTGAAG
CGTAGTACGCA -> GTAGTACGCAA
CGTAGTGAGCT -> GTAGTGAGCTT
CGTATCTTCTG -> GTATCTTCTGG
CGTCAGTGTTA -> GTCAGTGTTAT
CGTCATAACGG -> GTCATAACGGA
CGTGAGAAAGT -> GTGAGAAAGTG
CGTGAGAGGAT -> GTGAGAGGATT
CGTGATTAGGA -> GTGATTAGGAT
CGTGCAAGGGT -> GTGCAAGGGTA
CGTGTGCAGAA -> GTGTGCAGAAC
CGTGTTCAGTT -> GTGTTCAGTTT
CGTTAACTGGA -> GTTAACTGGAA
CGTTAGCCCTA -> GTTAGCCCTAT
CGTTCACGACT -> GTTCACGACTT
CGTTCATCGCC -> GTTCATCGCCG
CGTTCGCCCTG -> GTTCGCCCTGG
CGTTCTAAACT -> GTTCTAAACTT
CGTTGAAGGAT -> GTTGAAGGATT
CGTTGGAGATG -> GTTGGAGATGT
CTAAACTTTCA -> TAAACTTTCAC
CTAAAGAGTGC -> TAAAGAGTGCC
CTAAGCAGATA -> TAAGCAGATAC
CTAAGTAGTCT -> TAAGTAGTCTT
CTAATACTGAG -> TAATACTGAGC
CTAATCTGAGA -> TAATCTGAGAC
CTAATGATCTT -> TAATGATCTTG
CTAATGCAGGC -> TAATGCAGGCC
CTACCGCCAGA -> TACCGCCAGAA
CTACCTAGCCC -> TACCTAGCCCA
CTACCTTCGAC -> TACCTTCGACC
CTACGTCATAA -> TACGTCATAAC
CTACGTTAACT -> TACGTTAACTG
CTACTGCGCTG -> TACTGCGCTGT
CTACTGGCACT -> TACTGGCACTA
CTACTGTTGAC -> TACTGTTGACT
CTACTTATCAG -> TACTTATCAGC
CTAGAATGTCC -> TAGAATGTCCT
CTAGCAGATAG -> TAGCAGATAGC
CTAGCCCAAGT -> TAGCCCAAGTG
CTAGCGAAGTG -> TAGCGAAGTGG
CTAGCGCTTCG -> TAGCGCTTCGC
CTAGCTGAGCC -> TAGCTGAGCCT
CTAGGCCACCT -> TAGGCCACCTT
CTAGGGAGTCG -> TAGGGAGTCGA
CTAGTGCAACT -> TAGTGCAACTT
CTATCGCCAGT -> TATCGCCAGTA
CTATGCCCCAG -> TATGCCCCAGC
CTATGTAGTGT -> TATGTAGTGTG
CTATTCGCCTT -> TATTCGCCTTG
CTATTGATAAG -> TATTGATAAGA
CTATTTAGAAG -> TATTTAGAAGA
CTATTTTATGG -> TATTTTATGGC
CTCAAACGGGT -> TCAAACGGGTC
CTCACCAGTTT -> TCACCAGTTTA
CTCACGCCTCG -> TCACGCCTCGC
CTCAGCATCAA -> TCAGCATCAAG
CTCAGCCACGC -> TCAGCCACGCC
CTCAGTATTTC -> TCAGTATTTCG
CTCAGTTGGCC -> TCAGTTGGCCC
CTCATTGAGTT -> TCATTGAGTTA
CTCATTGTTAG -> TCATTGTTAGG
CTCATTTGGTT -> TCATTTGGTTA
CTCCCAGCAAA -> TCCCAGCAAAT
CTCCCTAGCAG -> TCCCTAGCAGA
CTCCTAAAGAG -> TCCTAAAGAGT
CTCCTCGAGTT -> TCCTCGAGTTG
CTCGAGTTGCT -> TCGAGTTGCTA
CTCGATTATGA -> TCGATTATGAA
CTCGCCCAAGA -> TCGCCCAAGAT
CTCTAAGCAGA -> TCTAAGCAGAT
CTCTAATACTG -> TCTAATACTGA
CTCTCAAACGG -> TCTCAAACGGG
CTCTCTTAAAA -> TCTCTTAAAAT
CTCTGATTGTT -> TCTGATTGTTA
CTCTGGGTGGG -> TCTGGGTGGGC
CTCTTAAAATA -> TCTTAAAATAA
CTGACCCGAAG -> TGACCCGAAGG
CTGACTCCTAA -> TGACTCCTAAA
CTGAGACGTGA -> TGAGACGTGAT
CTGAGATCAGG -> TGAGATCAGGA
CTGAGCAACGA -> TGAGCAACGAT
CTGAGCAATAA -> TGAGCAATAAA
CTGAGCCTTAC -> TGAGCCTTACA
CTGAGCTATCG -> TGAGCTATCGC
CTGAGCTCACG -> TGAGCTCACGC
CTGAGGGTAGA -> TGAGGGTAGAA
CTGATTGTTAA -> TGATTGTTAAG
CTGATTTGGAA -> TGATTTGGAAG
CTGCAGAACGT -> TGCAGAACGTG
CTGCCGGCATC -> TGCCGGCATCC
CTGCCTCATTT -> TGCCTCATTTG
CTGCGCTGTTA -> TGCGCTGTTAC
CTGGAATCGTG -> TGGAATCGTGT
CTGGAGAGTAC -> TGGAGAGTACT
CTGGCACTACC -> TGGCACTACCT
CTGGCTCCCTA -> TGGCTCCCTAG
CTGGGACGACT -> TGGGACGACTG
CTGGGTGGGCG -> TGGGTGGGCGA
CTGGTCGGAGG -> TGGTCGGAGGG
CTGTCCGGTAA -> TGTCCGGTAAC
CTGTGTAATGC -> TGTGTAATGCT
CTGTTACAAGC -> TGTTACAAGCT
CTGTTGACTTA -> TGTTGACTTAC
CTTAAAATAAT -> TTAAAATAATC
CTTAAAGCGCC -> TTAAAGCGCCT
CTTAATACTTA -> TTAATACTTAT
CTTACATCTGA -> TTACATCTGAG
CTTACTCCTCG -> TTACTCCTCGA
CTTACTCTCAA -> TTACTCTCAAA
CTTAGCATATC -> TTAGCATATCT
CTTATCAGCTA -> TTATCAGCTAA
CTTATGTCTAG -> TTATGTCTAGC
CTTATTTGCGA -> TTATTTGCGAC
CTTCAAGCCAC -> TTCAAGCCACA
CTTCAGCCTTA -> TTCAGCCTTAC
CTTCCCGCGCA -> TTCCCGCGCAC
CTTCGACCGGA -> TTCGACCGGAC
CTTCGCTAATG -> TTCGCTAATGC
CTTCGCTCACC -> TTCGCTCACCA
CTTCTACTTAT -> TTCTACTTATC
CTTCTCCCAGC -> TTCTCCCAGCA
CTTCTCTAAGC -> TTCTCTAAGCA
CTTCTGAGCTC -> TTCTGAGCTCA
CTTCTGGCTCC -> TTCTGGCTCCC
CTTGAATTACG -> TTGAATTACGC
CTTGCAAGTTA -> TTGCAAGTTAC
CTTGCGAAATA -> TTGCGAAATAC
CTTGGCTTAGC -> TTGGCTTAGCA
CTTGGGTGCCT -> TTGGGTGCCTG
CTTGTGCGTTG -> TTGTGCGTTGA
CTTGTTCCGGA -> TTGTTCCGGAA
CTTTAATCCCC -> TTTAATCCCCG
CTTTCAAAGAA -> TTTCAAAGAAT
CTTTCACCGCT -> TTTCACCGCTG
CTTTCGGGAGC -> TTTCGGGAGCA
CTTTCTTCTCC -> TTTCTTCTCCC
CTTTGAGAGGC -> TTTGAGAGGCC
CTTTGGGGCTC -> TTTGGGGCTCA
CTTTTACGGCC -> TTTTACGGCCA
CTTTTACGTTC -> TTTTACGTTCA
GAAAGTGTGAG -> AAAGTGTGAGG
GAAATACTTTC -> AAATACTTTCA
GAACAAGAACC -> AACAAGAACCC
GAACAGATTAT -> AACAGATTATT
GAACAGCCACT -> AACAGCCACTT
GAACCCCTGAG -> AACCCCTGAGC
GAACGGTCTTG -> AACGGTCTTGG
GAACGTGAGAA -> AACGTGAGAAA
GAACGTGCAAG -> AACGTGCAAGG
GAACTATGCCC -> AACTATGCCCC
GAACTTTTACG -> AACTTTTACGT
GAAGACGTTCA -> AAGACGTTCAC
GAAGATAAGTT -> AAGATAAGTTT
GAAGATTTGTG -> AAGATTTGTGC
GAAGCCAGTCA -> AAGCCAGTCAG
GAAGCTTAAAG -> AAGCTTAAAGC
GAAGGATTGAT -> AAGGATTGATC
GAAGGCTTCGC -> AAGGCTTCGCT
GAAGGGACAAC -> AAGGGACAACC
GAAGGGAGCAT -> AAGGGAGCATT
GAAGTGAAGAT -> AAGTGAAGATT
GAAGTGGAAGG -> AAGTGGAAGGG
GAAGTGGCGGG -> AAGTGGCGGGT
GAATAATATAC -> AATAATATACA
GAATATCATTA -> AATATCATTAC
GAATCATCTAC -> AATCATCTACG
GAATCGTGTTC -> AATCGTGTTCA
GAATGATTGCC -> AATGATTGCCT
GAATGGATATA -> AATGGATATAT
GAATGGCGGTG -> AATGGCGGTGA
GAATGTCCTCA -> AATGTCCTCAT
GAATGTCGCCG -> AATGTCGCCGA
GAATTACGCGT -> AATTACGCGTT
GACAACCACGT -> ACAACCACGTT
GACAATAGGGG -> ACAATAGGGGG
GACACAAGCTT -> ACACAAGCTTG
GACACGATGCC -> ACACGATGCCA
GACACTCAGCC -> ACACTCAGCCA
GACACTGATTT -> ACACTGATTTG
GACAGAGCAAC -> ACAGAGCAACT
GACAGAGGGCC -> ACAGAGGGCCT
GACATACGAAC -> ACATACGAACA
GACATGGTCAA -> ACATGGTCAAA
GACCCCAATAA -> ACCCCAATAAC
GACCCGAAGGC -> ACCCGAAGGCT
GACCGGACTAT -> ACCGGACTATT
GACGAATGGCG -> ACGAATGGCGG
GACGACTGGAG -> ACGACTGGAGA
GACGATGCACG -> ACGATGCACGC
GACGGCAAGCG -> ACGGCAAGCGA
GACGGCCCGAC -> ACGGCCCGACG
GACGGTAGGAC -> ACGGTAGGACG
GACGTGATTAG -> ACGTGATTAGG
GACGTTCACGA -> ACGTTCACGAC
GACGTTCTAAA -> ACGTTCTAAAC
GACTATTTTAT -> ACTATTTTATG
GACTCAGTTGG -> ACTCAGTTGGC
GACTCCTAAAG -> ACTCCTAAAGA
GACTCTAATAC -> ACTCTAATACT
GACTGGAGAGT -> ACTGGAGAGTA
GACTTACTCCT -> ACTTACTCCTC
GACTTCTCTAA -> ACTTCTCTAAG
GAGAAAGTGTG -> AGAAAGTGTGA
GAGAAGGGACA -> AGAAGGGACAA
GAGACGTGATT -> AGACGTGATTA
GAGAGGATTGT -> AGAGGATTGTA
GAGAGGCCAGT -> AGAGGCCAGTC
GAGAGTACTAC -> AGAGTACTACG
GAGATCAGGAA -> AGATCAGGAAT
GAGATGAAGTG -> AGATGAAGTGA
GAGATGTAAAC -> AGATGTAAACC
GAGATGTGCTG -> AGATGTGCTGC
GAGCAACGATT -> AGCAACGATTC
GAGCAACTATT -> AGCAACTATTG
GAGCAATAAAA -> AGCAATAAAAT
GAGCACAAACT -> AGCACAAACTT
GAGCACACCTA -> AGCACACCTAC
GAGCACCCATG -> AGCACCCATGC
GAGCAGAACAA -> AGCAGAACAAG
GAGCATTCTTT -> AGCATTCTTTA
GAGCCCATCCA -> AGCCCATCCAG
GAGCCTTACAT -> AGCCTTACATC
GAGCTATCGCC -> AGCTATCGCCA
GAGCTCACGCC -> AGCTCACGCCT
GAGCTCGATTA -> AGCTCGATTAT
GAGCTTTTACG -> AGCTTTTACGG
GAGGACGGCAA -> AGGACGGCAAG
GAGGAGCACAC -> AGGAGCACACC
GAGGATTGTAC -> AGGATTGTACG
GAGGATTTGGG -> AGGATTTGGGG
GAGGCCAGTCG -> AGGCCAGTCGG
GAGGGCCTACC -> AGGGCCTACCG
GAGGGGGGCAT -> AGGGGGGCATT
GAGGGTAGAAT -> AGGGTAGAATA
GAGGTCAAAAT -> AGGTCAAAATT
GAGTACTACGT -> AGTACTACGTC
GAGTCGATGGA -> AGTCGATGGAC
GAGTCTCTCTT -> AGTCTCTCTTA
GAGTGCCTAAT -> AGTGCCTAATC
GAGTTACAAAC -> AGTTACAAACT
GAGTTAGCTTC -> AGTTAGCTTCA
GAGTTGCTATG -> AGTTGCTATGT
GATAAGACTCA -> ATAAGACTCAG
GATAAGTTTGA -> ATAAGTTTGAC
GATAATCTGGT -> ATAATCTGGTC
GATACGCGGGG -> ATACGCGGGGC
GATAGCGGTGT -> ATAGCGGTGTT
GATATATTTCC -> ATATATTTCCA
GATCAACATTT -> ATCAACATTTA
GATCAGGAATG -> ATCAGGAATGA
GATCCCCAGGC -> ATCCCCAGGCC
GATCGACAGAG -> ATCGACAGAGC
GATCGCGCTCA -> ATCGCGCTCAT
GATCGCTGCCG -> ATCGCTGCCGG
GATCTTGGGTG -> ATCTTGGGTGC
GATGAAGTGAA -> ATGAAGTGAAG
GATGCACGCTT -> ATGCACGCTTT
GATGCCATCGT -> ATGCCATCGTA
GATGCTAGGCC -> ATGCTAGGCCA
GATGGACACTC -> ATGGACACTCA
GATGTAAACCT -> ATGTAAACCTA
GATGTGAGTTA -> ATGTGAGTTAG
GATGTGCGGCT -> ATGTGCGGCTA
GATGTGCTGCA -> ATGTGCTGCAG
GATTAGGATCC -> ATTAGGATCCC
GATTATGAATG -> ATTATGAATGG
GATTATTAACA -> ATTATTAACAA
GATTCATCACC -> ATTCATCACCT
GATTCGATTCA -> ATTCGATTCAT
GATTGATCAAC -> ATTGATCAACA
GATTGCCTGAG -> ATTGCCTGAGC
GATTGGTATAT -> ATTGGTATATA
GATTGTACGGC -> ATTGTACGGCG
GATTGTTAAGG -> ATTGTTAAGGT
GATTTGGAAGC -> ATTTGGAAGCC
GATTTGGGGAC -> ATTTGGGGACA
GATTTGTGCGG -> ATTTGTGCGGA
GCAAATAGGTG -> CAAATAGGTGC
GCAACGATTCG -> CAACGATTCGA
GCAACGCCCTA -> CAACGCCCTAG
GCAACTATTGA -> CAACTATTGAT
GCAACTTGCGA -> CAACTTGCGAA
GCAAGCGAGGA -> CAAGCGAGGAT
GCAAGGGTATG -> CAAGGGTATGC
GCAAGTTACAA -> CAAGTTACAAG
GCAATAAAATC -> CAATAAAATCG
GCAATCATGCC -> CAATCATGCCT
GCACAAACTTG -> CACAAACTTGT
GCACACCTACT -> CACACCTACTG
GCACCCATGCA -> CACCCATGCAA
GCACCGCTAGC -> CACCGCTAGCG
GCACGCTTTGA -> CACGCTTTGAG
GCACGGAACTA -> CACGGAACTAT
GCACGGCTACT -> CACGGCTACTG
GCACGGTTGAT -> CACGGTTGATT
GCACTACCTTC -> CACTACCTTCG
GCAGAACAAGA -> CAGAACAAGAA
GCAGAACGTGA -> CAGAACGTGAG
GCAGAACGTGC -> CAGAACGTGCA
GCAGATACGCG -> CAGATACGCGG
GCAGATAGCGG -> CAGATAGCGGT
GCAGGCCAATC -> CAGGCCAATCG
GCATAAAGAAG -> CATAAAGAAGA
GCATATCTGCC -> CATATCTGCCT
GCATCAAGTTT -> CATCAAGTTTA
GCATCCTTCTG -> CATCCTTCTGA
GCATGTGCGCA -> CATGTGCGCAC
GCATTACACCT -> CATTACACCTC
GCATTCTTTAA -> CATTCTTTAAT
GCATTGTCGCA -> CATTGTCGCAC
GCCAAAGCATT -> CCAAAGCATTG
GCCAATCGGGA -> CCAATCGGGAA
GCCACAACGGT -> CCACAACGGTC
GCCACAGGACA -> CCACAGGACAG
GCCACCAACGA -> CCACCAACGAC
GCCACCTTATT -> CCACCTTATTT
GCCACGCCACC -> CCACGCCACCA
GCCACTTCAGC -> CCACTTCAGCC
GCCAGTATGCC -> CCAGTATGCCA
GCCAGTCAGGA -> CCAGTCAGGAC
GCCAGTCGGCT -> CCAGTCGGCTG
GCCATCGTAAG -> CCATCGTAAGT
GCCATTGACAT -> CCATTGACATA
GCCCAAGATGT -> CCCAAGATGTG
GCCCAAGTGAT -> CCCAAGTGATC
GCCCATCCAGT -> CCCATCCAGTA
GCCCCAGCTCT -> CCCCAGCTCTG
GCCCGACGAAT -> CCCGACGAATG
GCCCTAGAATG -> CCCTAGAATGT
GCCCTAGGGAG -> CCCTAGGGAGT
GCCCTATTTAG -> CCCTATTTAGA
GCCCTGGGACG -> CCCTGGGACGA
GCCGACACGAT -> CCGACACGATG
GCCGAGCCCAT -> CCGAGCCCATC
GCCGGCATCCT -> CCGGCATCCTT
GCCGTAGTGAG -> CCGTAGTGAGC
GCCTAATCTGA -> CCTAATCTGAG
GCCTACCGCCA -> CCTACCGCCAG
GCCTCATTTGG -> CCTCATTTGGT
GCCTCGCCCAA -> CCTCGCCCAAG
GCCTGAGATCA -> CCTGAGATCAG
GCCTGAGCAAC -> CCTGAGCAACG
GCCTTAATACT -> CCTTAATACTT
GCCTTACATCT -> CCTTACATCTG
GCCTTACTCTC -> CCTTACTCTCA
GCCTTCTACTT -> CCTTCTACTTA
GCCTTGCAAGT -> CCTTGCAAGTT
GCCTTTGGGGC -> CCTTTGGGGCT
GCGAAATACTT -> CGAAATACTTT
GCGAAGTGGAA -> CGAAGTGGAAG
GCGACAATAGG -> CGACAATAGGG
GCGAGGATTTG -> CGAGGATTTGG
GCGATGTGAGT -> CGATGTGAGTT
GCGCACGGAAC -> CGCACGGAACT
GCGCACGGTTG -> CGCACGGTTGA
GCGCCGTAGTG -> CGCCGTAGTGA
GCGCCTTCTAC -> CGCCTTCTACT
GCGCTCATTGA -> CGCTCATTGAG
GCGCTGTTACA -> CGCTGTTACAA
GCGCTTCGCTA -> CGCTTCGCTAA
GCGGAACTTTT -> CGGAACTTTTA
GCGGACACAAG -> CGGACACAAGC
GCGGATGCTAG -> CGGATGCTAGG
GCGGCTAGCGC -> CGGCTAGCGCT
GCGGGGCATGT -> CGGGGCATGTG
GCGGGTAGCGG -> CGGGTAGCGGA
GCGGTGACGAT -> CGGTGACGATG
GCGGTGTTGTG -> CGGTGTTGTGA
GCGTAGTACGC -> CGTAGTACGCA
GCGTCAGTGTT -> CGTCAGTGTTA
GCGTTGAAGGA -> CGTTGAAGGAT
GCGTTGGAGAT -> CGTTGGAGATG
GCTAAGTAGTC -> CTAAGTAGTCT
GCTAATGCAGG -> CTAATGCAGGC
GCTACCTAGCC -> CTACCTAGCCC
GCTACTGCGCT -> CTACTGCGCTG
GCTACTGTTGA -> CTACTGTTGAC
GCTAGCGAAGT -> CTAGCGAAGTG
GCTAGCGCTTC -> CTAGCGCTTCG
GCTAGGCCACC -> CTAGGCCACCT
GCTATCGCCAG -> CTATCGCCAGT
GCTATGTAGTG -> CTATGTAGTGT
GCTCACCAGTT -> CTCACCAGTTT
GCTCACGCCTC -> CTCACGCCTCG
GCTCAGTATTT -> CTCAGTATTTC
GCTCATTGAGT -> CTCATTGAGTT
GCTCCCTAGCA -> CTCCCTAGCAG
GCTCGATTATG -> CTCGATTATGA
GCTCTGGGTGG -> CTCTGGGTGGG
GCTGACCCGAA -> CTGACCCGAAG
GCTGAGCCTTA -> CTGAGCCTTAC
GCTGCAGAACG -> CTGCAGAACGT
GCTGCCGGCAT -> CTGCCGGCATC
GCTGTGTAATG -> CTGTGTAATGC
GCTGTTACAAG -> CTGTTACAAGC
GCTTAAAGCGC -> CTTAAAGCGCC
GCTTAGCATAT -> CTTAGCATATC
GCTTCAAGCCA -> CTTCAAGCCAC
GCTTCCCGCGC -> CTTCCCGCGCA
GCTTCGCTAAT -> CTTCGCTAATG
GCTTCGCTCAC -> CTTCGCTCACC
GCTTGTTCCGG -> CTTGTTCCGGA
GCTTTCGGGAG -> CTTTCGGGAGC
GCTTTGAGAGG -> CTTTGAGAGGC
GCTTTTACGGC -> CTTTTACGGCC
GGAACAGATTA -> GAACAGATTAT
GGAACGGTCTT -> GAACGGTCTTG
GGAACTATGCC -> GAACTATGCCC
GGAACTTTTAC -> GAACTTTTACG
GGAAGCCAGTC -> GAAGCCAGTCA
GGAAGGGAGCA -> GAAGGGAGCAT
GGAATCATCTA -> GAATCATCTAC
GGAATCGTGTT -> GAATCGTGTTC
GGAATGATTGC -> GAATGATTGCC
GGACAACCACG -> GACAACCACGT
GGACACAAGCT -> GACACAAGCTT
GGACACTCAGC -> GACACTCAGCC
GGACACTGATT -> GACACTGATTT
GGACAGAGGGC -> GACAGAGGGCC
GGACATGGTCA -> GACATGGTCAA
GGACCCCAATA -> GACCCCAATAA
GGACGACTGGA -> GACGACTGGAG
GGACGGCAAGC -> GACGGCAAGCG
GGACGTTCTAA -> GACGTTCTAAA
GGACTATTTTA -> GACTATTTTAT
GGAGAGTACTA -> GAGAGTACTAC
GGAGATGTAAA -> GAGATGTAAAC
GGAGATGTGCT -> GAGATGTGCTG
GGAGCACACCT -> GAGCACACCTA
GGAGCACCCAT -> GAGCACCCATG
GGAGCAGAACA -> GAGCAGAACAA
GGAGCATTCTT -> GAGCATTCTTT
GGAGCTCGATT -> GAGCTCGATTA
GGAGGGGGGCA -> GAGGGGGGCAT
GGAGTCGATGG -> GAGTCGATGGA
GGATATATTTC -> GATATATTTCC
GGATCCCCAGG -> GATCCCCAGGC
GGATGCTAGGC -> GATGCTAGGCC
GGATTGATCAA -> GATTGATCAAC
GGATTGTACGG -> GATTGTACGGC
GGATTTGGGGA -> GATTTGGGGAC
GGCAAGCGAGG -> GCAAGCGAGGA
GGCACTACCTT -> GCACTACCTTC
GGCATCCTTCT -> GCATCCTTCTG
GGCATGTGCGC -> GCATGTGCGCA
GGCATTACACC -> GCATTACACCT
GGCCAATCGGG -> GCCAATCGGGA
GGCCACAACGG -> GCCACAACGGT
GGCCACCTTAT -> GCCACCTTATT
GGCCAGTCGGC -> GCCAGTCGGCT
GGCCCGACGAA -> GCCCGACGAAT
GGCCCTAGAAT -> GCCCTAGAATG
GGCCTACCGCC -> GCCTACCGCCA
GGCCTTAATAC -> GCCTTAATACT
GGCGATGTGAG -> GCGATGTGAGT
GGCGCCGTAGT -> GCGCCGTAGTG
GGCGGGTAGCG -> GCGGGTAGCGG
GGCGGTGACGA -> GCGGTGACGAT
GGCGTAGTACG -> GCGTAGTACGC
GGCTACTGCGC -> GCTACTGCGCT
GGCTAGCGCTT -> GCTAGCGCTTC
GGCTCAGTATT -> GCTCAGTATTT
GGCTCCCTAGC -> GCTCCCTAGCA
GGCTGACCCGA -> GCTGACCCGAA
GGCTTAGCATA -> GCTTAGCATAT
GGCTTCGCTCA -> GCTTCGCTCAC
GGGAACGGTCT -> GGAACGGTCTT
GGGACAACCAC -> GGACAACCACG
GGGACACTGAT -> GGACACTGATT
GGGACGACTGG -> GGACGACTGGA
GGGAGCACCCA -> GGAGCACCCAT
GGGAGCAGAAC -> GGAGCAGAACA
GGGAGCATTCT -> GGAGCATTCTT
GGGAGCTCGAT -> GGAGCTCGATT
GGGAGTCGATG -> GGAGTCGATGG
GGGCATGTGCG -> GGCATGTGCGC
GGGCATTACAC -> GGCATTACACC
GGGCCTACCGC -> GGCCTACCGCC
GGGCGATGTGA -> GGCGATGTGAG
GGGCTCAGTAT -> GGCTCAGTATT
GGGGACACTGA -> GGGACACTGAT
GGGGAGCAGAA -> GGGAGCAGAAC
GGGGAGCTCGA -> GGGAGCTCGAT
GGGGCATGTGC -> GGGCATGTGCG
GGGGCATTACA -> GGGCATTACAC
GGGGCTCAGTA -> GGGCTCAGTAT
GGGGGAGCTCG -> GGGGAGCTCGA
GGGGGCATTAC -> GGGGCATTACA
GGGGGGCATTA -> GGGGGCATTAC
GGGTAGAATAT -> GGTAGAATATC
GGGTAGCGGAC -> GGTAGCGGACA
GGGTATGCATA -> GGTATGCATAA
GGGTCGTGAGA -> GGTCGTGAGAG
GGGTGCCTGAG -> GGTGCCTGAGA
GGGTGGGCGAT -> GGTGGGCGATG
GGTAACCAAGG -> GTAACCAAGGA
GGTAGAATATC -> GTAGAATATCA
GGTAGCGGACA -> GTAGCGGACAC
GGTAGGACGTT -> GTAGGACGTTC
GGTAGGTGACT -> GTAGGTGACTC
GGTATATAGCG -> GTATATAGCGT
GGTATGCATAA -> GTATGCATAAA
GGTCAAAATTT -> GTCAAAATTTC
GGTCAAAGTCA -> GTCAAAGTCAC
GGTCGGAGGGG -> GTCGGAGGGGG
GGTCGTGAGAG -> GTCGTGAGAGG
GGTCTCTGATT -> GTCTCTGATTG
GGTCTTGGCTT -> GTCTTGGCTTA
GGTGACGATGC -> GTGACGATGCA
GGTGACTCTAA -> GTGACTCTAAT
GGTGCCTGAGA -> GTGCCTGAGAT
GGTGCTTTCGG -> GTGCTTTCGGG
GGTGGGCGATG -> GTGGGCGATGT
GGTGTTGTGAG -> GTGTTGTGAGG
GGTTACAAGTA -> GTTACAAGTAC
GGTTACCAGAG -> GTTACCAGAGA
GGTTGATTGGT -> GTTGATTGGTA
GTAAACCTAAT -> TAAACCTAATG
GTAACCAAGGA -> TAACCAAGGAA
GTAAGTTGAAG -> TAAGTTGAAGT
GTAATGCTTCC -> TAATGCTTCCC
GTACACCGTGT -> TACACCGTGTG
GTACATCCAGT -> TACATCCAGTC
GTACGCAACGC -> TACGCAACGCC
GTACGGCGCCG -> TACGGCGCCGT
GTACTACGTCA -> TACTACGTCAT
GTAGAATATCA -> TAGAATATCAT
GTAGCGGACAC -> TAGCGGACACA
GTAGGACGTTC -> TAGGACGTTCT
GTAGGTGACTC -> TAGGTGACTCT
GTAGTACGCAA -> TAGTACGCAAC
GTAGTCTTGAA -> TAGTCTTGAAT
GTAGTGAGCTT -> TAGTGAGCTTT
GTAGTGTGAGA -> TAGTGTGAGAA
GTATATAGCGT -> TATATAGCGTC
GTATCTTCTGG -> TATCTTCTGGC
GTATGCATAAA -> TATGCATAAAG
GTATGCCAAAG -> TATGCCAAAGC
GTATTTCGGAG -> TATTTCGGAGA
GTATTTGAATA -> TATTTGAATAA
GTCAAAATTTC -> TCAAAATTTCC
GTCAAAGTCAC -> TCAAAGTCACG
GTCACGATAAT -> TCACGATAATC
GTCAGGACATG -> TCAGGACATGG
GTCAGTGTTAT -> TCAGTGTTATA
GTCATAACGGA -> TCATAACGGAC
GTCCATGAGCA -> TCCATGAGCAC
GTCCGGTAACC -> TCCGGTAACCA
GTCCTCATTGT -> TCCTCATTGTT
GTCGATGGACA -> TCGATGGACAC
GTCGCACCGCT -> TCGCACCGCTA
GTCGCACGGCT -> TCGCACGGCTA
GTCGCCGAGCC -> TCGCCGAGCCC
GTCGGAGGGGG -> TCGGAGGGGGG
GTCGGCTGACC -> TCGGCTGACCC
GTCGTGAGAGG -> TCGTGAGAGGA
GTCTAGCTGAG -> TCTAGCTGAGC
GTCTCTCTTAA -> TCTCTCTTAAA
GTCTCTGATTG -> TCTCTGATTGT
GTCTTGAATTA -> TCTTGAATTAC
GTCTTGGCTTA -> TCTTGGCTTAG
GTGAAGATTTG -> TGAAGATTTGT
GTGACGATGCA -> TGACGATGCAC
GTGACTCTAAT -> TGACTCTAATA
GTGAGAAAGTG -> TGAGAAAGTGT
GTGAGAAGGGA -> TGAGAAGGGAC
GTGAGAGGATT -> TGAGAGGATTG
GTGAGCTTTTA -> TGAGCTTTTAC
GTGAGGAGCAC -> TGAGGAGCACA
GTGAGGTCAAA -> TGAGGTCAAAA
GTGAGTTAGCT -> TGAGTTAGCTT
GTGATCGCGCT -> TGATCGCGCTC
GTGATTAGGAT -> TGATTAGGATC
GTGCAACTTGC -> TGCAACTTGCG
GTGCAAGGGTA -> TGCAAGGGTAT
GTGCAGAACGT -> TGCAGAACGTG
GTGCCTAATCT -> TGCCTAATCTG
GTGCCTGAGAT -> TGCCTGAGATC
GTGCGCACGGA -> TGCGCACGGAA
GTGCGGATGCT -> TGCGGATGCTA
GTGCGGCTAGC -> TGCGGCTAGCG
GTGCGTTGAAG -> TGCGTTGAAGG
GTGCTGCAGAA -> TGCTGCAGAAC
GTGCTTTCGGG -> TGCTTTCGGGA
GTGGAAGGGAG -> TGGAAGGGAGC
GTGGCGGGTAG -> TGGCGGGTAGC
GTGGGCGATGT -> TGGGCGATGTG
GTGTAATGCTT -> TGTAATGCTTC
GTGTGAGAAGG -> TGTGAGAAGGG
GTGTGAGGAGC -> TGTGAGGAGCA
GTGTGCAGAAC -> TGTGCAGAACG
GTGTTATAAGT -> TGTTATAAGTA
GTGTTCAGTTT -> TGTTCAGTTTA
GTGTTGTGAGG -> TGTTGTGAGGT
GTTAACTGGAA -> TTAACTGGAAT
GTTAAGGTAGG -> TTAAGGTAGGT
GTTACAAACTG -> TTACAAACTGT
GTTACAAGAAG -> TTACAAGAAGC
GTTACAAGCTA -> TTACAAGCTAC
GTTACAAGTAC -> TTACAAGTACA
GTTACCAGAGA -> TTACCAGAGAT
GTTAGCCCTAT -> TTAGCCCTATT
GTTAGCTTCAA -> TTAGCTTCAAG
GTTAGGTTACC -> TTAGGTTACCA
GTTATAAGTAT -> TTATAAGTATT
GTTCACGACTT -> TTCACGACTTC
GTTCAGTTTAC -> TTCAGTTTACC
GTTCATCGCCG -> TTCATCGCCGA
GTTCCGGAATC -> TTCCGGAATCA
GTTCGCCCTGG -> TTCGCCCTGGG
GTTCTAAACTT -> TTCTAAACTTT
GTTGAAGGATT -> TTGAAGGATTG
GTTGAAGTGGC -> TTGAAGTGGCG
GTTGACTTACT -> TTGACTTACTC
GTTGATTGGTA -> TTGATTGGTAT
GTTGCTATGTA -> TTGCTATGTAG
GTTGGAGATGT -> TTGGAGATGTG
GTTGGCCCTAG -> TTGGCCCTAGA
GTTGTCCATGA -> TTGTCCATGAG
GTTGTGAGGTC -> TTGTGAGGTCA
GTTTACCTGAC -> TTTACCTGACT
GTTTAGAGTCT -> TTTAGAGTCTC
GTTTATATAAG -> TTTATATAAGC
GTTTGACGGCC -> TTTGACGGCCC
TAAAATAATCT -> AAAATAATCTA
TAAAATCGATC -> AAAATCGATCG
TAAACCTAATG -> AAACCTAATGA
TAAACTTTCAC -> AAACTTTCACC
TAAAGAAGATA -> AAAGAAGATAA
TAAAGAGTGCC -> AAAGAGTGCCT
TAAAGCGCCTT -> AAAGCGCCTTC
TAACAACAGAT -> AACAACAGATC
TAACCAAGGAA -> AACCAAGGAAC
TAACCGGGGAG -> AACCGGGGAGC
TAACGGACCCC -> AACGGACCCCA
TAACTGGAATC -> AACTGGAATCG
TAAGACTCAGT -> AAGACTCAGTT
TAAGCAGATAC -> AAGCAGATACG
TAAGCCATTGA -> AAGCCATTGAC
TAAGGTAGGTG -> AAGGTAGGTGA
TAAGTAGTCTT -> AAGTAGTCTTG
TAAGTATTTGA -> AAGTATTTGAA
TAAGTTGAAGT -> AAGTTGAAGTG
TAAGTTTGACG -> AAGTTTGACGG
TAATACTGAGC -> AATACTGAGCT
TAATACTTATG -> AATACTTATGT
TAATATACAGT -> AATATACAGTT
TAATCCCCGTA -> AATCCCCGTAT
TAATCTAGTGC -> AATCTAGTGCA
TAATCTGAGAC -> AATCTGAGACG
TAATCTGGTCG -> AATCTGGTCGG
TAATCTTTCTT -> AATCTTTCTTC
TAATGATCTTG -> AATGATCTTGG
TAATGCAGGCC -> AATGCAGGCCA
TAATGCTTCCC -> AATGCTTCCCG
TACAAACTGTC -> ACAAACTGTCC
TACAAGAAGCT -> ACAAGAAGCTT
TACAAGCTACT -> ACAAGCTACTG
TACAAGTACAC -> ACAAGTACACC
TACACCGTGTG -> ACACCGTGTGC
TACACCTCAGC -> ACACCTCAGCA
TACAGTTGTCC -> ACAGTTGTCCA
TACATCCAGTC -> ACATCCAGTCG
TACATCTGAGG -> ACATCTGAGGG
TACCAGAGATG -> ACCAGAGATGA
TACCTAGCCCA -> ACCTAGCCCAA
TACCTGACTCC -> ACCTGACTCCT
TACCTTCGACC -> ACCTTCGACCG
TACGAACAGCC -> ACGAACAGCCA
TACGCAACGCC -> ACGCAACGCCC
TACGCGGGGCA -> ACGCGGGGCAT
TACGCGTTGGA -> ACGCGTTGGAG
TACGCTACCTA -> ACGCTACCTAG
TACGGCCACAA -> ACGGCCACAAC
TACGGCGCCGT -> ACGGCGCCGTA
TACGTCATAAC -> ACGTCATAACG
TACGTTAACTG -> ACGTTAACTGG
TACGTTCATCG -> ACGTTCATCGC
TACTACGTCAT -> ACTACGTCATA
TACTCCTCGAG -> ACTCCTCGAGT
TACTCTCAAAC -> ACTCTCAAACG
TACTGAGCTAT -> ACTGAGCTATC
TACTGCGCTGT -> ACTGCGCTGTT
TACTGGCACTA -> ACTGGCACTAC
TACTGTTGACT -> ACTGTTGACTT
TACTTATCAGC -> ACTTATCAGCT
TACTTATGTCT -> ACTTATGTCTA
TACTTTCAAAG -> ACTTTCAAAGA
TAGAAGACGTT -> AGAAGACGTTC
TAGAATATCAT -> AGAATATCATT
TAGAATGTCCT -> AGAATGTCCTC
TAGAGGACGGC -> AGAGGACGGCA
TAGAGTCTCTC -> AGAGTCTCTCT
TAGCAGATAGC -> AGCAGATAGCG
TAGCATATCTG -> AGCATATCTGC
TAGCCCAAGTG -> AGCCCAAGTGA
TAGCCCTATTT -> AGCCCTATTTA
TAGCGAAGTGG -> AGCGAAGTGGA
TAGCGCTTCGC -> AGCGCTTCGCT
TAGCGGACACA -> AGCGGACACAA
TAGCGGTGTTG -> AGCGGTGTTGT
TAGCGTCAGTG -> AGCGTCAGTGT
TAGCTGAGCCT -> AGCTGAGCCTT
TAGCTTCAAGC -> AGCTTCAAGCC
TAGGACGTTCT -> AGGACGTTCTA
TAGGATCCCCA -> AGGATCCCCAG
TAGGCCACCTT -> AGGCCACCTTA
TAGGGAGTCGA -> AGGGAGTCGAT
TAGGGGGAGCT -> AGGGGGAGCTC
TAGGTGACTCT -> AGGTGACTCTA
TAGGTGCTTTC -> AGGTGCTTTCG
TAGGTTACCAG -> AGGTTACCAGA
TAGTACGCAAC -> AGTACGCAACG
TAGTCTTGAAT -> AGTCTTGAATT
TAGTGAGCTTT -> AGTGAGCTTTT
TAGTGCAACTT -> AGTGCAACTTG
TAGTGTGAGAA -> AGTGTGAGAAG
TATAAGCCATT -> ATAAGCCATTG
TATAAGTATTT -> ATAAGTATTTG
TATACAGTTGT -> ATACAGTTGTC
TATAGCGTCAG -> ATAGCGTCAGT
TATATAAGCCA -> ATATAAGCCAT
TATATAGCGTC -> ATATAGCGTCA
TATATTTCCAA -> ATATTTCCAAA
TATCAGCTAAG -> ATCAGCTAAGT
TATCATTACGC -> ATCATTACGCT
TATCGCCAGTA -> ATCGCCAGTAT
TATCTGCCTCA -> ATCTGCCTCAT
TATCTTCTGGC -> ATCTTCTGGCT
TATGAATGGAT -> ATGAATGGATA
TATGCATAAAG -> ATGCATAAAGA
TATGCCAAAGC -> ATGCCAAAGCA
TATGCCCCAGC -> ATGCCCCAGCT
TATGGCGTAGT -> ATGGCGTAGTA
TATGTAGTGTG -> ATGTAGTGTGA
TATGTCTAGCT -> ATGTCTAGCTG
TATTAACAACA -> ATTAACAACAG
TATTCGCCTTG -> ATTCGCCTTGC
TATTGATAAGA -> ATTGATAAGAC
TATTTAGAAGA -> ATTTAGAAGAC
TATTTCCAAAT -> ATTTCCAAATA
TATTTCGGAGA -> ATTTCGGAGAT
TATTTGAATAA -> ATTTGAATAAT
TATTTGCGACA -> ATTTGCGACAA
TATTTTATGGC -> ATTTTATGGCG
TCAAAATTTCC -> CAAAATTTCCC
TCAAACGGGTC -> CAAACGGGTCG
TCAAAGAATGT -> CAAAGAATGTC
TCAAAGTCACG -> CAAAGTCACGA
TCAACATTTAA -> CAACATTTAAT
TCAAGCCACAG -> CAAGCCACAGG
TCAAGTTTATA -> CAAGTTTATAT
TCACCAGTTTA -> CACCAGTTTAG
TCACCGCTGTG -> CACCGCTGTGT
TCACCTATTCG -> CACCTATTCGC
TCACGACTTCT -> CACGACTTCTC
TCACGATAATC -> CACGATAATCT
TCACGCCTCGC -> CACGCCTCGCC
TCAGCATCAAG -> CAGCATCAAGT
TCAGCCACGCC -> CAGCCACGCCA
TCAGCCTTACT -> CAGCCTTACTC
TCAGCTAAGTA -> CAGCTAAGTAG
TCAGGAATGAT -> CAGGAATGATT
TCAGGACATGG -> CAGGACATGGT
TCAGTATTTCG -> CAGTATTTCGG
TCAGTGTTATA -> CAGTGTTATAA
TCAGTTGGCCC -> CAGTTGGCCCT
TCAGTTTACCT -> CAGTTTACCTG
TCATAACGGAC -> CATAACGGACC
TCATCACCTAT -> CATCACCTATT
TCATCGCCGAC -> CATCGCCGACA
TCATCTACGTT -> CATCTACGTTA
TCATGCCTTTG -> CATGCCTTTGG
TCATTACGCTA -> CATTACGCTAC
TCATTGAGTTA -> CATTGAGTTAC
TCATTGTTAGG -> CATTGTTAGGT
TCATTTGGTTA -> CATTTGGTTAC
TCCAAATAGAG -> CCAAATAGAGG
TCCAGTACATC -> CCAGTACATCC
TCCAGTCGCAC -> CCAGTCGCACC
TCCATGAGCAC -> CCATGAGCACA
TCCCAGCAAAT -> CCCAGCAAATA
TCCCCAGGCCT -> CCCCAGGCCTT
TCCCCGTATCT -> CCCCGTATCTT
TCCCGCGCACG -> CCCGCGCACGG
TCCCGTTAGCC -> CCCGTTAGCCC
TCCCTAGCAGA -> CCCTAGCAGAT
TCCGGAATCAT -> CCGGAATCATC
TCCGGTAACCA -> CCGGTAACCAA
TCCTAAAGAGT -> CCTAAAGAGTG
TCCTCATTGTT -> CCTCATTGTTA
TCCTCGAGTTG -> CCTCGAGTTGC
TCCTTCTGAGC -> CCTTCTGAGCT
TCGACAGAGCA -> CGACAGAGCAA
TCGACCGGACT -> CGACCGGACTA
TCGAGTTGCTA -> CGAGTTGCTAT
TCGATCGCTGC -> CGATCGCTGCC
TCGATGGACAC -> CGATGGACACT
TCGATTATGAA -> CGATTATGAAT
TCGATTCATCA -> CGATTCATCAC
TCGCACCGCTA -> CGCACCGCTAG
TCGCACGGCTA -> CGCACGGCTAC
TCGCCAGTATG -> CGCCAGTATGC
TCGCCCAAGAT -> CGCCCAAGATG
TCGCCCTGGGA -> CGCCCTGGGAC
TCGCCGACACG -> CGCCGACACGA
TCGCCGAGCCC -> CGCCGAGCCCA
TCGCCTTGCAA -> CGCCTTGCAAG
TCGCGCTCATT -> CGCGCTCATTG
TCGCTAATGCA -> CGCTAATGCAG
TCGCTCACCAG -> CGCTCACCAGT
TCGCTGCCGGC -> CGCTGCCGGCA
TCGGAGATGTA -> CGGAGATGTAA
TCGGAGGGGGG -> CGGAGGGGGGC
TCGGCTGACCC -> CGGCTGACCCG
TCGGGAACGGT -> CGGGAACGGTC
TCGGGAGCACC -> CGGGAGCACCC
TCGTAAGTTGA -> CGTAAGTTGAA
TCGTGAGAGGA -> CGTGAGAGGAT
TCGTGTTCAGT -> CGTGTTCAGTT
TCTAAACTTTC -> CTAAACTTTCA
TCTAAGCAGAT -> CTAAGCAGATA
TCTAATACTGA -> CTAATACTGAG
TCTACGTTAAC -> CTACGTTAACT
TCTACTTATCA -> CTACTTATCAG
TCTAGCTGAGC -> CTAGCTGAGCC
TCTAGTGCAAC -> CTAGTGCAACT
TCTCAAACGGG -> CTCAAACGGGT
TCTCCCAGCAA -> CTCCCAGCAAA
TCTCTAAGCAG -> CTCTAAGCAGA
TCTCTCTTAAA -> CTCTCTTAAAA
TCTCTGATTGT -> CTCTGATTGTT
TCTCTTAAAAT -> CTCTTAAAATA
TCTGAGACGTG -> CTGAGACGTGA
TCTGAGCTCAC -> CTGAGCTCACG
TCTGAGGGTAG -> CTGAGGGTAGA
TCTGATTGTTA -> CTGATTGTTAA
TCTGCCTCATT -> CTGCCTCATTT
TCTGGCTCCCT -> CTGGCTCCCTA
TCTGGGTGGGC -> CTGGGTGGGCG
TCTGGTCGGAG -> CTGGTCGGAGG
TCTTAAAATAA -> CTTAAAATAAT
TCTTCTCCCAG -> CTTCTCCCAGC
TCTTCTGGCTC -> CTTCTGGCTCC
TCTTGAATTAC -> CTTGAATTACG
TCTTGGCTTAG -> CTTGGCTTAGC
TCTTGGGTGCC -> CTTGGGTGCCT
TCTTTAATCCC -> CTTTAATCCCC
TCTTTCTTCTC -> CTTTCTTCTCC
TGAAGATTTGT -> GAAGATTTGTG
TGAAGGATTGA -> GAAGGATTGAT
TGAAGTGAAGA -> GAAGTGAAGAT
TGAAGTGGCGG -> GAAGTGGCGGG
TGAATAATATA -> GAATAATATAC
TGAATGGATAT -> GAATGGATATA
TGAATTACGCG -> GAATTACGCGT
TGACATACGAA -> GACATACGAAC
TGACCCGAAGG -> GACCCGAAGGC
TGACGATGCAC -> GACGATGCACG
TGACGGCCCGA -> GACGGCCCGAC
TGACTCCTAAA -> GACTCCTAAAG
TGACTCTAATA -> GACTCTAATAC
TGACTTACTCC -> GACTTACTCCT
TGAGAAAGTGT -> GAGAAAGTGTG
TGAGAAGGGAC -> GAGAAGGGACA
TGAGACGTGAT -> GAGACGTGATT
TGAGAGGATTG -> GAGAGGATTGT
TGAGAGGCCAG -> GAGAGGCCAGT
TGAGATCAGGA -> GAGATCAGGAA
TGAGCAACGAT -> GAGCAACGATT
TGAGCAATAAA -> GAGCAATAAAA
TGAGCACAAAC -> GAGCACAAACT
TGAGCCTTACA -> GAGCCTTACAT
TGAGCTATCGC -> GAGCTATCGCC
TGAGCTCACGC -> GAGCTCACGCC
TGAGCTTTTAC -> GAGCTTTTACG
TGAGGAGCACA -> GAGGAGCACAC
TGAGGGTAGAA -> GAGGGTAGAAT
TGAGGTCAAAA -> GAGGTCAAAAT
TGAGTTACAAA -> GAGTTACAAAC
TGAGTTAGCTT -> GAGTTAGCTTC
TGATAAGACTC -> GATAAGACTCA
TGATCAACATT -> GATCAACATTT
TGATCGCGCTC -> GATCGCGCTCA
TGATCTTGGGT -> GATCTTGGGTG
TGATTAGGATC -> GATTAGGATCC
TGATTGCCTGA -> GATTGCCTGAG
TGATTGGTATA -> GATTGGTATAT
TGATTGTTAAG -> GATTGTTAAGG
TGATTTGGAAG -> GATTTGGAAGC
TGCAACTTGCG -> GCAACTTGCGA
TGCAAGGGTAT -> GCAAGGGTATG
TGCAAGTTACA -> GCAAGTTACAA
TGCAATCATGC -> GCAATCATGCC
TGCACGCTTTG -> GCACGCTTTGA
TGCAGAACGTG -> GCAGAACGTGA,GCAGAACGTGC
TGCAGGCCAAT -> GCAGGCCAATC
TGCATAAAGAA -> GCATAAAGAAG
TGCCAAAGCAT -> GCCAAAGCATT
TGCCATCGTAA -> GCCATCGTAAG
TGCCCCAGCTC -> GCCCCAGCTCT
TGCCGGCATCC -> GCCGGCATCCT
TGCCTAATCTG -> GCCTAATCTGA
TGCCTCATTTG -> GCCTCATTTGG
TGCCTGAGATC -> GCCTGAGATCA
TGCCTGAGCAA -> GCCTGAGCAAC
TGCCTTTGGGG -> GCCTTTGGGGC
TGCGAAATACT -> GCGAAATACTT
TGCGACAATAG -> GCGACAATAGG
TGCGCACGGAA -> GCGCACGGAAC
TGCGCTGTTAC -> GCGCTGTTACA
TGCGGATGCTA -> GCGGATGCTAG
TGCGGCTAGCG -> GCGGCTAGCGC
TGCGTTGAAGG -> GCGTTGAAGGA
TGCTAGGCCAC -> GCTAGGCCACC
TGCTATGTAGT -> GCTATGTAGTG
TGCTGCAGAAC -> GCTGCAGAACG
TGCTTCCCGCG -> GCTTCCCGCGC
TGCTTTCGGGA -> GCTTTCGGGAG
TGGAAGCCAGT -> GGAAGCCAGTC
TGGAAGGGAGC -> GGAAGGGAGCA
TGGAATCGTGT -> GGAATCGTGTT
TGGACACTCAG -> GGACACTCAGC
TGGAGAGTACT -> GGAGAGTACTA
TGGAGATGTGC -> GGAGATGTGCT
TGGATATATTT -> GGATATATTTC
TGGCACTACCT -> GGCACTACCTT
TGGCCCTAGAA -> GGCCCTAGAAT
TGGCGGGTAGC -> GGCGGGTAGCG
TGGCGGTGACG -> GGCGGTGACGA
TGGCGTAGTAC -> GGCGTAGTACG
TGGCTCCCTAG -> GGCTCCCTAGC
TGGCTTAGCAT -> GGCTTAGCATA
TGGGACGACTG -> GGGACGACTGG
TGGGCGATGTG -> GGGCGATGTGA
TGGGGACACTG -> GGGGACACTGA
TGGGGCTCAGT -> GGGGCTCAGTA
TGGGTGCCTGA -> GGGTGCCTGAG
TGGGTGGGCGA -> GGGTGGGCGAT
TGGTATATAGC -> GGTATATAGCG
TGGTCAAAGTC -> GGTCAAAGTCA
TGGTCGGAGGG -> GGTCGGAGGGG
TGGTTACAAGT -> GGTTACAAGTA
TGTAAACCTAA -> GTAAACCTAAT
TGTAATGCTTC -> GTAATGCTTCC
TGTACGGCGCC -> GTACGGCGCCG
TGTAGTGTGAG -> GTAGTGTGAGA
TGTCCATGAGC -> GTCCATGAGCA
TGTCCGGTAAC -> GTCCGGTAACC
TGTCCTCATTG -> GTCCTCATTGT
TGTCGCACGGC -> GTCGCACGGCT
TGTCGCCGAGC -> GTCGCCGAGCC
TGTCTAGCTGA -> GTCTAGCTGAG
TGTGAGAAGGG -> GTGAGAAGGGA
TGTGAGGAGCA -> GTGAGGAGCAC
TGTGAGGTCAA -> GTGAGGTCAAA
TGTGAGTTAGC -> GTGAGTTAGCT
TGTGCAGAACG -> GTGCAGAACGT
TGTGCGCACGG -> GTGCGCACGGA
TGTGCGGATGC -> GTGCGGATGCT
TGTGCGGCTAG -> GTGCGGCTAGC
TGTGCGTTGAA -> GTGCGTTGAAG
TGTGCTGCAGA -> GTGCTGCAGAA
TGTGTAATGCT -> GTGTAATGCTT
TGTTAAGGTAG -> GTTAAGGTAGG
TGTTACAAGCT -> GTTACAAGCTA
TGTTAGGTTAC -> GTTAGGTTACC
TGTTATAAGTA -> GTTATAAGTAT
TGTTCAGTTTA -> GTTCAGTTTAC
TGTTCCGGAAT -> GTTCCGGAATC
TGTTGACTTAC -> GTTGACTTACT
TGTTGTGAGGT -> GTTGTGAGGTC
TTAAAATAATC -> TAAAATAATCT
TTAAAGCGCCT -> TAAAGCGCCTT
TTAACAACAGA -> TAACAACAGAT
TTAACTGGAAT -> TAACTGGAATC
TTAAGGTAGGT -> TAAGGTAGGTG
TTAATACTTAT -> TAATACTTATG
TTAATCCCCGT -> TAATCCCCGTA
TTAATCTTTCT -> TAATCTTTCTT
TTACAAACTGT -> TACAAACTGTC
TTACAAGAAGC -> TACAAGAAGCT
TTACAAGCTAC -> TACAAGCTACT
TTACAAGTACA -> TACAAGTACAC
TTACACCTCAG -> TACACCTCAGC
TTACATCTGAG -> TACATCTGAGG
TTACCAGAGAT -> TACCAGAGATG
TTACCTGACTC -> TACCTGACTCC
TTACGCGTTGG -> TACGCGTTGGA
TTACGCTACCT -> TACGCTACCTA
TTACGGCCACA -> TACGGCCACAA
TTACGTTCATC -> TACGTTCATCG
TTACTCCTCGA -> TACTCCTCGAG
TTACTCTCAAA -> TACTCTCAAAC
TTAGAAGACGT -> TAGAAGACGTT
TTAGAGTCTCT -> TAGAGTCTCTC
TTAGCATATCT -> TAGCATATCTG
TTAGCCCTATT -> TAGCCCTATTT
TTAGCTTCAAG -> TAGCTTCAAGC
TTAGGATCCCC -> TAGGATCCCCA
TTAGGTTACCA -> TAGGTTACCAG
TTATAAGTATT -> TATAAGTATTT
TTATATAAGCC -> TATATAAGCCA
TTATCAGCTAA -> TATCAGCTAAG
TTATGAATGGA -> TATGAATGGAT
TTATGGCGTAG -> TATGGCGTAGT
TTATGTCTAGC -> TATGTCTAGCT
TTATTAACAAC -> TATTAACAACA
TTATTTGCGAC -> TATTTGCGACA
TTCAAAGAATG -> TCAAAGAATGT
TTCAAGCCACA -> TCAAGCCACAG
TTCACCGCTGT -> TCACCGCTGTG
TTCACGACTTC -> TCACGACTTCT
TTCAGCCTTAC -> TCAGCCTTACT
TTCAGTTTACC -> TCAGTTTACCT
TTCATCACCTA -> TCATCACCTAT
TTCATCGCCGA -> TCATCGCCGAC
TTCCAAATAGA -> TCCAAATAGAG
TTCCCGCGCAC -> TCCCGCGCACG
TTCCCGTTAGC -> TCCCGTTAGCC
TTCCGGAATCA -> TCCGGAATCAT
TTCGACCGGAC -> TCGACCGGACT
TTCGATTCATC -> TCGATTCATCA
TTCGCCCTGGG -> TCGCCCTGGGA
TTCGCCTTGCA -> TCGCCTTGCAA
TTCGCTAATGC -> TCGCTAATGCA
TTCGCTCACCA -> TCGCTCACCAG
TTCGGAGATGT -> TCGGAGATGTA
TTCGGGAGCAC -> TCGGGAGCACC
TTCTAAACTTT -> TCTAAACTTTC
TTCTACTTATC -> TCTACTTATCA
TTCTCCCAGCA -> TCTCCCAGCAA
TTCTCTAAGCA -> TCTCTAAGCAG
TTCTGAGCTCA -> TCTGAGCTCAC
TTCTGGCTCCC -> TCTGGCTCCCT
TTCTTCTCCCA -> TCTTCTCCCAG
TTCTTTAATCC -> TCTTTAATCCC
TTGAAGGATTG -> TGAAGGATTGA
TTGAAGTGGCG -> TGAAGTGGCGG
TTGAATAATAT -> TGAATAATATA
TTGAATTACGC -> TGAATTACGCG
TTGACATACGA -> TGACATACGAA
TTGACGGCCCG -> TGACGGCCCGA
TTGACTTACTC -> TGACTTACTCC
TTGAGAGGCCA -> TGAGAGGCCAG
TTGAGTTACAA -> TGAGTTACAAA
TTGATAAGACT -> TGATAAGACTC
TTGATCAACAT -> TGATCAACATT
TTGATTGGTAT -> TGATTGGTATA
TTGCAAGTTAC -> TGCAAGTTACA
TTGCCTGAGCA -> TGCCTGAGCAA
TTGCGAAATAC -> TGCGAAATACT
TTGCGACAATA -> TGCGACAATAG
TTGCTATGTAG -> TGCTATGTAGT
TTGGAAGCCAG -> TGGAAGCCAGT
TTGGAGATGTG -> TGGAGATGTGC
TTGGCCCTAGA -> TGGCCCTAGAA
TTGGCTTAGCA -> TGGCTTAGCAT
TTGGGGACACT -> TGGGGACACTG
TTGGGGCTCAG -> TGGGGCTCAGT
TTGGGTGCCTG -> TGGGTGCCTGA
TTGGTATATAG -> TGGTATATAGC
TTGGTTACAAG -> TGGTTACAAGT
TTGTACGGCGC -> TGTACGGCGCC
TTGTCCATGAG -> TGTCCATGAGC
TTGTCGCACGG -> TGTCGCACGGC
TTGTGAGGTCA -> TGTGAGGTCAA
TTGTGCGGATG -> TGTGCGGATGC
TTGTGCGTTGA -> TGTGCGTTGAA
TTGTTAAGGTA -> TGTTAAGGTAG
TTGTTAGGTTA -> TGTTAGGTTAC
TTGTTCCGGAA -> TGTTCCGGAAT
TTTAATCCCCG -> TTAATCCCCGT
TTTAATCTTTC -> TTAATCTTTCT
TTTACCTGACT -> TTACCTGACTC
TTTACGGCCAC -> TTACGGCCACA
TTTACGTTCAT -> TTACGTTCATC
TTTAGAAGACG -> TTAGAAGACGT
TTTAGAGTCTC -> TTAGAGTCTCT
TTTATATAAGC -> TTATATAAGCC
TTTATGGCGTA -> TTATGGCGTAG
TTTCAAAGAAT -> TTCAAAGAATG
TTTCACCGCTG -> TTCACCGCTGT
TTTCCAAATAG -> TTCCAAATAGA
TTTCCCGTTAG -> TTCCCGTTAGC
TTTCGGAGATG -> TTCGGAGATGT
TTTCGGGAGCA -> TTCGGGAGCAC
TTTCTTCTCCC -> TTCTTCTCCCA
TTTGAATAATA -> TTGAATAATAT
TTTGACGGCCC -> TTGACGGCCCG
TTTGAGAGGCC -> TTGAGAGGCCA
TTTGCGACAAT -> TTGCGACAATA
TTTGGAAGCCA -> TTGGAAGCCAG
TTTGGGGACAC -> TTGGGGACACT
TTTGGGGCTCA -> TTGGGGCTCAG
TTTGGTTACAA -> TTGGTTACAAG
TTTGTGCGGAT -> TTGTGCGGATG
TTTTACGGCCA -> TTTACGGCCAC
TTTTACGTTCA -> TTTACGTTCAT
TTTTATGGCGT -> TTTATGGCGTA