AAAAAACCCAC -> AAAAACCCACT
AAAAACCCACT -> AAAACCCACTA
AAAAACTTCCC -> AAAACTTCCCC
AAAAATCGCGG -> AAAATCGCGGT
AAAACCCACTA -> AAACCCACTAC
AAAACTGGCTC -> AAACTGGCTCT
AAAACTTCCCC -> AAACTTCCCCG
AAAATCGCGGT -> AAATCGCGGTT
AAAATCGTAAC -> AAATCGTAACG
AAAATTGGCAA -> AAATTGGCAAG
AAACAGGGTAA -> AACAGGGTAAG
AAACATGCTGT -> AACATGCTGTA
AAACCCACTAC -> AACCCACTACT
AAACCGTATGG -> AACCGTATGGG
AAACCTCGACT -> AACCTCGACTA
AAACGAGAGTT -> AACGAGAGTTT
AAACTGGCTCT -> AACTGGCTCTC
AAACTTCCCCG -> AACTTCCCCGG
AAAGGAGACAA -> AAGGAGACAAG
AAAGTATGAGC -> AAGTATGAGCT
AAAGTCAGTCC -> AAGTCAGTCCG
AAAGTCGGCGT -> AAGTCGGCGTC
AAAGTGAACGT -> AAGTGAACGTA
AAATAAAGTAT -> AATAAAGTATG
AAATAAGTTTA -> AATAAGTTTAG
AAATCCGCTTC -> AATCCGCTTCT
AAATCGCGGTT -> AATCGCGGTTT
AAATCGGGCAC -> AATCGGGCACC
AAATCGTAACG -> AATCGTAACGC
AAATTGGCAAG -> AATTGGCAAGT
AACACCCACTA -> ACACCCACTAG
AACACTCGATG -> ACACTCGATGG
AACAGGGTAAG -> ACAGGGTAAGC
AACATGCTGTA -> ACATGCTGTAT
AACCCACTACT -> ACCCACTACTA
AACCGTATGGG -> ACCGTATGGGG
AACCTCGACTA -> ACCTCGACTAC
AACGAGAGTTT -> ACGAGAGTTTG
AACGAGCTGGT -> ACGAGCTGGTG
AACGATGCTCT -> ACGATGCTCTT
AACGCAAGGAG -> ACGCAAGGAGA
AACGCTTTTGG -> ACGCTTTTGGC
AACGTAGTGGC -> ACGTAGTGGCG
AACGTTGCAGC -> ACGTTGCAGCC
AACTAATGGCA -> ACTAATGGCAT
AACTAGCGTTA -> ACTAGCGTTAT
AACTGGCCGCG -> ACTGGCCGCGG
AACTGGCTCTC -> ACTGGCTCTCC
AACTTCCACGA -> ACTTCCACGAC
AACTTCCCCGG -> ACTTCCCCGGG
AAGAAAGTCAG -> AGAAAGTCAGT
AAGAACGAGCT -> AGAACGAGCTG
AAGACCAACTG -> AGACCAACTGG
AAGAGAGGCCC -> AGAGAGGCCCT
AAGAGCAGTAT -> AGAGCAGTATT
AAGAGCGGGAT -> AGAGCGGGATC
AAGAGGCAAGT -> AGAGGCAAGTG
AAGATAGACTC -> AGATAGACTCA
AAGATCAATTT -> AGATCAATTTG
AAGCACGTTGG -> AGCACGTTGGC
AAGCCTGTCAA -> AGCCTGTCAAT
AAGCGCATCCT -> AGCGCATCCTG
AAGCTATGGTA -> AGCTATGGTAT
AAGGAGAATCA -> AGGAGAATCAA
AAGGAGACAAG -> AGGAGACAAGA
AAGGCCGCCAC -> AGGCCGCCACA
AAGTAATCGTT -> AGTAATCGTTG
AAGTATGAGCT -> AGTATGAGCTT
AAGTCAGTCCG -> AGTCAGTCCGT
AAGTCGGCGTC -> AGTCGGCGTCA
AAGTGAACGTA -> AGTGAACGTAG
AAGTGTTACTG -> AGTGTTACTGC
AAGTTGGTATG -> AGTTGGTATGA
AAGTTTAGGAA -> AGTTTAGGAAT
AAGTTTAGTAC -> AGTTTAGTACG
AATAAAGTATG -> ATAAAGTATGA
AATAAGTTTAG -> ATAAGTTTAGG
AATAGACCGAT -> ATAGACCGATA
AATATCTCATC -> ATATCTCATCA
AATCAAATCGG -> ATCAAATCGGG
AATCCACACCA -> ATCCACACCAT
AATCCATATGT -> ATCCATATGTT
AATCCGCTTCT -> ATCCGCTTCTA
AATCGCGGTTT -> ATCGCGGTTTT
AATCGGGCACC -> ATCGGGCACCG
AATCGTAACGC -> ATCGTAACGCA
AATCGTACTCG -> ATCGTACTCGG
AATCGTTGTGT -> ATCGTTGTGTG
AATCTCGCAGT -> ATCTCGCAGTA
AATCTTCCTAC -> ATCTTCCTACG
AATGAGCGATT -> ATGAGCGATTG
AATGGCATAAT -> ATGGCATAATA
AATGGCATGCC -> ATGGCATGCCC
AATGGGTTAAC -> ATGGGTTAACG
AATGTCAGTTA -> ATGTCAGTTAA
AATGTTGACGC -> ATGTTGACGCA
AATTAAGAGCG -> ATTAAGAGCGG
AATTCCCAATG -> ATTCCCAATGT
AATTCCGAAGT -> ATTCCGAAGTT
AATTCGGTCTA -> ATTCGGTCTAC
AATTGGCAAGT -> ATTGGCAAGTT
AATTTATGGTG -> ATTTATGGTGA
AATTTCGGGCA -> ATTTCGGGCAC
AATTTGTCCAA -> ATTTGTCCAAA
ACAAAACTGGC -> CAAAACTGGCT
ACAAATAAAGT -> CAAATAAAGTA
ACAACACTCGA -> CAACACTCGAT
ACAACTAGCGT -> CAACTAGCGTT
ACAAGAGAGGC -> CAAGAGAGGCC
ACAAGATCAAT -> CAAGATCAATT
ACAAGCGCATC -> CAAGCGCATCC
ACAATGGGTTA -> CAATGGGTTAA
ACAATTCCCAA -> CAATTCCCAAT
ACAATTCGGTC -> CAATTCGGTCT
ACACCAACGTT -> CACCAACGTTG
ACACCATTCAC -> CACCATTCACG
ACACCCACTAG -> CACCCACTAGT
ACACGACAACA -> CACGACAACAC
ACACTCGATGG -> CACTCGATGGG
ACAGATAGTTG -> CAGATAGTTGT
ACAGGGTAAGC -> CAGGGTAAGCA
ACATACTGACA -> CATACTGACAT
ACATAGAAACA -> CATAGAAACAG
ACATCCAGCGA -> CATCCAGCGAT
ACATGCTGTAT -> CATGCTGTATA
ACATGTTCCTT -> CATGTTCCTTA
ACATTGAGTCG -> CATTGAGTCGG
ACATTGCGCAG -> CATTGCGCAGG
ACATTTACGGC -> CATTTACGGCT
ACCAACGTTGC -> CCAACGTTGCA
ACCAACTGGCC -> CCAACTGGCCG
ACCAAGAAAGT -> CCAAGAAAGTC
ACCACGTACCC -> CCACGTACCCG
ACCATGCGCTA -> CCATGCGCTAG
ACCATTCACGA -> CCATTCACGAT
ACCCACTACTA -> CCCACTACTAG
ACCCACTAGTT -> CCCACTAGTTA
ACCCAGCGCGT -> CCCAGCGCGTT
ACCCGCCAGCC -> CCCGCCAGCCA
ACCCTTTCTGC -> CCCTTTCTGCT
ACCGATAAGAG -> CCGATAAGAGC
ACCGCGGAGCG -> CCGCGGAGCGT
ACCGCGGATTG -> CCGCGGATTGC
ACCGCGTGGGC -> CCGCGTGGGCC
ACCGGACTGGC -> CCGGACTGGCT
ACCGTATGGGG -> CCGTATGGGGT
ACCGTGACTGT -> CCGTGACTGTC
ACCTACGACAC -> CCTACGACACC
ACCTCGACTAC -> CCTCGACTACT
ACCTGTCTAGG -> CCTGTCTAGGA
ACGAACACCCA -> CGAACACCCAC
ACGACAACACT -> CGACAACACTC
ACGACACCAAC -> CGACACCAACG
ACGACTCGGGG -> CGACTCGGGGA
ACGAGAGTTTG -> CGAGAGTTTGT
ACGAGCGGCAG -> CGAGCGGCAGA
ACGAGCTGGTG -> CGAGCTGGTGT
ACGAGGACGGG -> CGAGGACGGGC
ACGATATGAAG -> CGATATGAAGA
ACGATGCTCTT -> CGATGCTCTTT
ACGATTCGTCA -> CGATTCGTCAT
ACGCAAGGAGA -> CGCAAGGAGAA
ACGCACACGAC -> CGCACACGACA
ACGCCCTTCGT -> CGCCCTTCGTA
ACGCCGCGTGC -> CGCCGCGTGCG
ACGCTGTTTGA -> CGCTGTTTGAA
ACGCTTACTAT -> CGCTTACTATT
ACGCTTTTGGC -> CGCTTTTGGCC
ACGGAGTTTCC -> CGGAGTTTCCG
ACGGCTACTTT -> CGGCTACTTTT
ACGGGCAAAAA -> CGGGCAAAAAA
ACGGTGTCACT -> CGGTGTCACTG
ACGTACCCGCC -> CGTACCCGCCA
ACGTAGACAAG -> CGTAGACAAGA
ACGTAGTGGCG -> CGTAGTGGCGG
ACGTCAAACCG -> CGTCAAACCGT
ACGTGGGCCCA -> CGTGGGCCCAG
ACGTTGCAGCC -> CGTTGCAGCCA
ACGTTGGCGGT -> CGTTGGCGGTT
ACTAAGGCCGC -> CTAAGGCCGCC
ACTAATGGCAT -> CTAATGGCATA,CTAATGGCATG
ACTACTAGGGT -> CTACTAGGGTC
ACTACTCGATA -> CTACTCGATAC
ACTAGCGTTAT -> CTAGCGTTATG
ACTAGGGTCAC -> CTAGGGTCACA
ACTAGTTAATC -> CTAGTTAATCT
ACTATTAAGAG -> CTATTAAGAGG
ACTATTTGATC -> CTATTTGATCT
ACTCACAATTC -> CTCACAATTCG
ACTCGATACTA -> CTCGATACTAT
ACTCGATGGGA -> CTCGATGGGAC
ACTCGCTGAGT -> CTCGCTGAGTT
ACTCGGGGATT -> CTCGGGGATTC
ACTCGGTTTGG -> CTCGGTTTGGA
ACTCTTAGTCG -> CTCTTAGTCGC
ACTCTTCGTCT -> CTCTTCGTCTT
ACTGAAGAACG -> CTGAAGAACGA
ACTGACATACT -> CTGACATACTG
ACTGACATAGA -> CTGACATAGAA
ACTGATATATG -> CTGATATATGT
ACTGCGGGACA -> CTGCGGGACAT
ACTGGCCGCGG -> CTGGCCGCGGA
ACTGGCTCTCC -> CTGGCTCTCCA
ACTGGCTGAGG -> CTGGCTGAGGT
ACTGTAGTGGC -> CTGTAGTGGCG
ACTGTCATCTA -> CTGTCATCTAG
ACTTATGATCG -> CTTATGATCGG
ACTTCCACGAC -> CTTCCACGACT
ACTTCCCCGGG -> CTTCCCCGGGG
ACTTGTCGCAA -> CTTGTCGCAAT
ACTTTTTAGAG -> CTTTTTAGAGC
AGAAACAGGGT -> GAAACAGGGTA
AGAAAGTCAGT -> GAAAGTCAGTC
AGAACGAGCTG -> GAACGAGCTGG
AGAATCAAATC -> GAATCAAATCG
AGACAAGAGAG -> GACAAGAGAGG
AGACAAGATCA -> GACAAGATCAA
AGACCAACTGG -> GACCAACTGGC
AGACCGATAAG -> GACCGATAAGA
AGACCGCGGAT -> GACCGCGGATT
AGACCGCGTGG -> GACCGCGTGGG
AGACGCTTACT -> GACGCTTACTA
AGACGTAGACA -> GACGTAGACAA
AGACTCACAAT -> GACTCACAATT
AGACTGTAGTG -> GACTGTAGTGG
AGAGAGCTGGC -> GAGAGCTGGCT
AGAGAGGCCCT -> GAGAGGCCCTG
AGAGCAGTATT -> GAGCAGTATTA
AGAGCGCGTTT -> GAGCGCGTTTG
AGAGCGGGATC -> GAGCGGGATCA
AGAGCTGGCTG -> GAGCTGGCTGA
AGAGGCAAGTG -> GAGGCAAGTGT
AGAGGCCCTGT -> GAGGCCCTGTA
AGAGGCTTAAA -> GAGGCTTAAAC
AGAGTTTGTTA -> GAGTTTGTTAC
AGATAGACTCA -> GATAGACTCAC
AGATAGTTACA -> GATAGTTACAT
AGATAGTTGTC -> GATAGTTGTCC
AGATCAATTTG -> GATCAATTTGT
AGCACGTTGGC -> GCACGTTGGCG
AGCAGCTCGTG -> GCAGCTCGTGC
AGCAGTATTAC -> GCAGTATTACG
AGCCAAAATTG -> GCCAAAATTGG
AGCCACAAATA -> GCCACAAATAA
AGCCGGATGTG -> GCCGGATGTGT
AGCCGGGGACG -> GCCGGGGACGT
AGCCTATGCAG -> GCCTATGCAGA
AGCCTGTCAAT -> GCCTGTCAATC
AGCGATTGCCA -> GCGATTGCCAT
AGCGATTTCCC -> GCGATTTCCCC
AGCGCATCCTG -> GCGCATCCTGG
AGCGCGTTGTT -> GCGCGTTGTTT
AGCGCGTTTGC -> GCGCGTTTGCA
AGCGGCAGACG -> GCGGCAGACGT
AGCGGGATCAG -> GCGGGATCAGC
AGCGGTCTGTC -> GCGGTCTGTCA
AGCGTAAAGTC -> GCGTAAAGTCG
AGCGTACTGAC -> GCGTACTGACA
AGCGTTATGGG -> GCGTTATGGGA
AGCTAGCTTGT -> GCTAGCTTGTG
AGCTATGGTAT -> GCTATGGTATC
AGCTCGTGCGT -> GCTCGTGCGTA
AGCTGGCTGAG -> GCTGGCTGAGG
AGCTGGTGTCG -> GCTGGTGTCGA
AGCTTGACCTG -> GCTTGACCTGT
AGCTTGTGTGC -> GCTTGTGTGCT
AGGAAACGAGA -> GGAAACGAGAG
AGGAATGTCAG -> GGAATGTCAGT
AGGACCCAGCG -> GGACCCAGCGC
AGGACGGGCAA -> GGACGGGCAAA
AGGAGAATCAA -> GGAGAATCAAA
AGGAGACAAGA -> GGAGACAAGAG
AGGATAAAATC -> GGATAAAATCG
AGGCAAGTGTT -> GGCAAGTGTTA
AGGCACCACGT -> GGCACCACGTA
AGGCCCTGTAG -> GGCCCTGTAGA
AGGCCGCCACA -> GGCCGCCACAA
AGGCCGGACCA -> GGCCGGACCAT
AGGCCTGTCCC -> GGCCTGTCCCC
AGGCTTAAACA -> GGCTTAAACAT
AGGGAGGTACT -> GGGAGGTACTT
AGGGCCCATTT -> GGGCCCATTTT
AGGGCTGCTCA -> GGGCTGCTCAG
AGGGTAAGCAC -> GGGTAAGCACG
AGGGTCACATT -> GGGTCACATTG
AGGTACTTATG -> GGTACTTATGA
AGGTCACCAAG -> GGTCACCAAGA
AGGTTTCGCGC -> GGTTTCGCGCT
AGTAAACCTCG -> GTAAACCTCGA
AGTAAAGGAGA -> GTAAAGGAGAC
AGTAATCGTTG -> GTAATCGTTGT
AGTACGGTGTC -> GTACGGTGTCA
AGTATGAGCTT -> GTATGAGCTTG
AGTATTACGGA -> GTATTACGGAG
AGTCAGTCCGT -> GTCAGTCCGTG
AGTCCGTGAAT -> GTCCGTGAATG
AGTCGCGGTCA -> GTCGCGGTCAG
AGTCGGCGTCA -> GTCGGCGTCAC
AGTCGGGTACA -> GTCGGGTACAA
AGTGAACGTAG -> GTGAACGTAGT
AGTGGCGCAAA -> GTGGCGCAAAT
AGTGGCGGCTT -> GTGGCGGCTTC
AGTGTTACTGC -> GTGTTACTGCG
AGTTAACTAAT -> GTTAACTAATG
AGTTAATCTTC -> GTTAATCTTCC
AGTTACATGTT -> GTTACATGTTC
AGTTGGTATGA -> GTTGGTATGAT
AGTTGTCCCCA -> GTTGTCCCCAA
AGTTTACGAGC -> GTTTACGAGCG
AGTTTAGGAAT -> GTTTAGGAATG
AGTTTAGTACG -> GTTTAGTACGG
AGTTTCCGTAT -> GTTTCCGTATG
AGTTTGTTACT -> GTTTGTTACTA
ATAAAATCGTA -> TAAAATCGTAA
ATAAAGTATGA -> TAAAGTATGAG
ATAAGAGCAGT -> TAAGAGCAGTA
ATAAGTTTAGG -> TAAGTTTAGGA
ATAATATCTCA -> TAATATCTCAT
ATACATCCAGC -> TACATCCAGCG
ATACTATTTGA -> TACTATTTGAT
ATACTGACATA -> TACTGACATAG
ATAGAAACAGG -> TAGAAACAGGG
ATAGACCGATA -> TAGACCGATAA
ATAGACCGCGG -> TAGACCGCGGA
ATAGACTCACA -> TAGACTCACAA
ATAGCGGTCTG -> TAGCGGTCTGT
ATAGGGAGGTA -> TAGGGAGGTAC
ATAGTTACATG -> TAGTTACATGT
ATAGTTGTCCC -> TAGTTGTCCCC
ATATATGTGGA -> TATATGTGGAA
ATATCTCATCA -> TATCTCATCAG
ATATGAAGATA -> TATGAAGATAG
ATATGTGGAAT -> TATGTGGAATT
ATATGTTGGTT -> TATGTTGGTTG
ATCAAATCGGG -> TCAAATCGGGC
ATCAAGTAATC -> TCAAGTAATCG
ATCAATTTGTC -> TCAATTTGTCC
ATCACGAACAC -> TCACGAACACC
ATCAGCCTATG -> TCAGCCTATGC
ATCAGGGCCCA -> TCAGGGCCCAT
ATCCACACCAT -> TCCACACCATT
ATCCAGCGATT -> TCCAGCGATTT
ATCCATATGTT -> TCCATATGTTG
ATCCGCTTCTA -> TCCGCTTCTAT
ATCCTGGGACT -> TCCTGGGACTA
ATCGCGGTTTT -> TCGCGGTTTTG
ATCGGCCGCGA -> TCGGCCGCGAG
ATCGGGCACCG -> TCGGGCACCGG
ATCGTAACGCA -> TCGTAACGCAA
ATCGTACTCGG -> TCGTACTCGGT
ATCGTTGCCAA -> TCGTTGCCAAA
ATCGTTGTGTG -> TCGTTGTGTGT
ATCTAATAGAC -> TCTAATAGACC
ATCTAGACTGT -> TCTAGACTGTA
ATCTAGGCCGG -> TCTAGGCCGGA
ATCTCATCAGG -> TCTCATCAGGG
ATCTCCTAGGG -> TCTCCTAGGGC
ATCTCGCAGTA -> TCTCGCAGTAA
ATCTGCCTTAA -> TCTGCCTTAAT
ATCTTCCTACG -> TCTTCCTACGA
ATGAAGATAGA -> TGAAGATAGAC
ATGAGCGATTG -> TGAGCGATTGC
ATGAGCTTGAC -> TGAGCTTGACC
ATGATCGGCCG -> TGATCGGCCGC
ATGATCTCCTA -> TGATCTCCTAG
ATGCAGACGCT -> TGCAGACGCTT
ATGCCCCTGCA -> TGCCCCTGCAC
ATGCCCGTGAC -> TGCCCGTGACG
ATGCCTGACGC -> TGCCTGACGCC
ATGCGCACTCG -> TGCGCACTCGC
ATGCGCTAGGC -> TGCGCTAGGCC
ATGCTCTTTCC -> TGCTCTTTCCT
ATGCTGTATAG -> TGCTGTATAGA
ATGGCATAATA -> TGGCATAATAT
ATGGCATGCCC -> TGGCATGCCCG
ATGGGACAAAA -> TGGGACAAAAC
ATGGGACCTAC -> TGGGACCTACG
ATGGGGTCTTA -> TGGGGTCTTAT
ATGGGTTAACG -> TGGGTTAACGC
ATGGTATCGTT -> TGGTATCGTTG
ATGGTGACTCT -> TGGTGACTCTT
ATGTCAGTTAA -> TGTCAGTTAAC
ATGTGGAATTT -> TGTGGAATTTC
ATGTGTCAACG -> TGTGTCAACGA
ATGTTCCTTAT -> TGTTCCTTATA
ATGTTGACGCA -> TGTTGACGCAC
ATGTTGGTTGG -> TGTTGGTTGGA
ATTAAGAGCGG -> TTAAGAGCGGG
ATTAAGAGGCA -> TTAAGAGGCAA
ATTACGGAGTT -> TTACGGAGTTT
ATTCACGATTC -> TTCACGATTCG
ATTCCCAATGT -> TTCCCAATGTT
ATTCCGAAGTT -> TTCCGAAGTTT
ATTCGGTCTAC -> TTCGGTCTACA
ATTCGTCATGC -> TTCGTCATGCC
ATTCTAAGCTA -> TTCTAAGCTAT
ATTGAGTCGGG -> TTGAGTCGGGT
ATTGCCATCTA -> TTGCCATCTAG
ATTGCGCAGGA -> TTGCGCAGGAA
ATTGCGTGGAG -> TTGCGTGGAGT
ATTGGAATCTC -> TTGGAATCTCG
ATTGGCAAGTT -> TTGGCAAGTTG
ATTTACGGCTA -> TTTACGGCTAC
ATTTATGGTGA -> TTTATGGTGAC
ATTTCCCCACG -> TTTCCCCACGA
ATTTCGGGCAC -> TTTCGGGCACA
ATTTGATCTAA -> TTTGATCTAAT
ATTTGTCCAAA -> TTTGTCCAAAA
ATTTTCTTGCG -> TTTTCTTGCGT
CAAAAAACCCA -> AAAAAACCCAC
CAAAAACTTCC -> AAAAACTTCCC
CAAAACTGGCT -> AAAACTGGCTC
CAAAATTGGCA -> AAAATTGGCAA
CAAACCGTATG -> AAACCGTATGG
CAAAGTGAACG -> AAAGTGAACGT
CAAATAAAGTA -> AAATAAAGTAT
CAAATAAGTTT -> AAATAAGTTTA
CAAATCCGCTT -> AAATCCGCTTC
CAAATCGGGCA -> AAATCGGGCAC
CAACACTCGAT -> AACACTCGATG
CAACGATGCTC -> AACGATGCTCT
CAACGTTGCAG -> AACGTTGCAGC
CAACTAGCGTT -> AACTAGCGTTA
CAACTGGCCGC -> AACTGGCCGCG
CAACTTCCACG -> AACTTCCACGA
CAAGAAAGTCA -> AAGAAAGTCAG
CAAGACCAACT -> AAGACCAACTG
CAAGAGAGGCC -> AAGAGAGGCCC
CAAGATCAATT -> AAGATCAATTT
CAAGCCTGTCA -> AAGCCTGTCAA
CAAGCGCATCC -> AAGCGCATCCT
CAAGGAGAATC -> AAGGAGAATCA
CAAGTAATCGT -> AAGTAATCGTT
CAAGTGTTACT -> AAGTGTTACTG
CAAGTTGGTAT -> AAGTTGGTATG
CAATCCACACC -> AATCCACACCA
CAATCCATATG -> AATCCATATGT
CAATGGGTTAA -> AATGGGTTAAC
CAATGTTGACG -> AATGTTGACGC
CAATTCCCAAT -> AATTCCCAATG
CAATTCGGTCT -> AATTCGGTCTA
CAATTTGTCCA -> AATTTGTCCAA
CACAAATAAAG -> ACAAATAAAGT
CACAATTCCCA -> ACAATTCCCAA
CACAATTCGGT -> ACAATTCGGTC
CACACCATTCA -> ACACCATTCAC
CACACGACAAC -> ACACGACAACA
CACAGATAGTT -> ACAGATAGTTG
CACATTGAGTC -> ACATTGAGTCG
CACATTTACGG -> ACATTTACGGC
CACCAACGTTG -> ACCAACGTTGC
CACCAAGAAAG -> ACCAAGAAAGT
CACCACGTACC -> ACCACGTACCC
CACCATTCACG -> ACCATTCACGA
CACCCACTAGT -> ACCCACTAGTT
CACCGCGGAGC -> ACCGCGGAGCG
CACCGGACTGG -> ACCGGACTGGC
CACGAACACCC -> ACGAACACCCA
CACGACAACAC -> ACGACAACACT
CACGACTCGGG -> ACGACTCGGGG
CACGAGGACGG -> ACGAGGACGGG
CACGATTCGTC -> ACGATTCGTCA
CACGTACCCGC -> ACGTACCCGCC
CACGTTGGCGG -> ACGTTGGCGGT
CACTACTAGGG -> ACTACTAGGGT
CACTAGTTAAT -> ACTAGTTAATC
CACTCGATGGG -> ACTCGATGGGA
CACTCGCTGAG -> ACTCGCTGAGT
CACTCTTAGTC -> ACTCTTAGTCG
CACTGAAGAAC -> ACTGAAGAACG
CAGACGCTTAC -> AGACGCTTACT
CAGACGTAGAC -> AGACGTAGACA
CAGAGGCTTAA -> AGAGGCTTAAA
CAGATAGTTGT -> AGATAGTTGTC
CAGCCAAAATT -> AGCCAAAATTG
CAGCCACAAAT -> AGCCACAAATA
CAGCCTATGCA -> AGCCTATGCAG
CAGCGATTTCC -> AGCGATTTCCC
CAGCGCGTTGT -> AGCGCGTTGTT
CAGCGTAAAGT -> AGCGTAAAGTC
CAGCTAGCTTG -> AGCTAGCTTGT
CAGCTCGTGCG -> AGCTCGTGCGT
CAGGAAACGAG -> AGGAAACGAGA
CAGGCACCACG -> AGGCACCACGT
CAGGGCCCATT -> AGGGCCCATTT
CAGGGTAAGCA -> AGGGTAAGCAC
CAGTAAAGGAG -> AGTAAAGGAGA
CAGTATTACGG -> AGTATTACGGA
CAGTCCGTGAA -> AGTCCGTGAAT
CAGTTAACTAA -> AGTTAACTAAT
CATAATATCTC -> ATAATATCTCA
CATACTGACAT -> ATACTGACATA
CATAGAAACAG -> ATAGAAACAGG
CATATGTTGGT -> ATATGTTGGTT
CATCACGAACA -> ATCACGAACAC
CATCAGGGCCC -> ATCAGGGCCCA
CATCCAGCGAT -> ATCCAGCGATT
CATCCTGGGAC -> ATCCTGGGACT
CATCTAGACTG -> ATCTAGACTGT
CATCTAGGCCG -> ATCTAGGCCGG
CATGCCCCTGC -> ATGCCCCTGCA
CATGCCCGTGA -> ATGCCCGTGAC
CATGCCTGACG -> ATGCCTGACGC
CATGCGCTAGG -> ATGCGCTAGGC
CATGCTGTATA -> ATGCTGTATAG
CATGTTCCTTA -> ATGTTCCTTAT
CATTCACGATT -> ATTCACGATTC
CATTGAGTCGG -> ATTGAGTCGGG
CATTGCGCAGG -> ATTGCGCAGGA
CATTTACGGCT -> ATTTACGGCTA
CATTTTCTTGC -> ATTTTCTTGCG
CCAAAAACTTC -> CAAAAACTTCC
CCAAAATTGGC -> CAAAATTGGCA
CCAAAGTGAAC -> CAAAGTGAACG
CCAAATAAGTT -> CAAATAAGTTT
CCAACGTTGCA -> CAACGTTGCAG
CCAACTGGCCG -> CAACTGGCCGC
CCAAGAAAGTC -> CAAGAAAGTCA
CCAATGTTGAC -> CAATGTTGACG
CCACAAATAAA -> CACAAATAAAG
CCACAATTCCC -> CACAATTCCCA
CCACACCATTC -> CACACCATTCA
CCACAGATAGT -> CACAGATAGTT
CCACGACTCGG -> CACGACTCGGG
CCACGAGGACG -> CACGAGGACGG
CCACGTACCCG -> CACGTACCCGC
CCACTACTAGG -> CACTACTAGGG
CCACTAGTTAA -> CACTAGTTAAT
CCAGCCAAAAT -> CAGCCAAAATT
CCAGCGATTTC -> CAGCGATTTCC
CCAGCGCGTTG -> CAGCGCGTTGT
CCAGCTAGCTT -> CAGCTAGCTTG
CCATATGTTGG -> CATATGTTGGT
CCATCACGAAC -> CATCACGAACA
CCATCTAGGCC -> CATCTAGGCCG
CCATGCGCTAG -> CATGCGCTAGG
CCATTCACGAT -> CATTCACGATT
CCATTTTCTTG -> CATTTTCTTGC
CCCAAATAAGT -> CCAAATAAGTT
CCCAATGTTGA -> CCAATGTTGAC
CCCACGAGGAC -> CCACGAGGACG
CCCACTACTAG -> CCACTACTAGG
CCCACTAGTTA -> CCACTAGTTAA
CCCAGCGCGTT -> CCAGCGCGTTG
CCCAGCTAGCT -> CCAGCTAGCTT
CCCATTTTCTT -> CCATTTTCTTG
CCCCAAATAAG -> CCCAAATAAGT
CCCCACGAGGA -> CCCACGAGGAC
CCCCGGGGCAA -> CCCGGGGCAAG
CCCCGTTGTCG -> CCCGTTGTCGT
CCCCTGCACTC -> CCCTGCACTCT
CCCGCCAGCCA -> CCGCCAGCCAA
CCCGGGGCAAG -> CCGGGGCAAGA
CCCGTGACGCT -> CCGTGACGCTG
CCCGTTGTCGT -> CCGTTGTCGTC
CCCTGCACTCT -> CCTGCACTCTT
CCCTGTAGAGA -> CCTGTAGAGAG
CCCTTCGTAGC -> CCTTCGTAGCA
CCCTTCTAAAA -> CCTTCTAAAAA
CCCTTTCTGCT -> CCTTTCTGCTT
CCGAAGTTTAG -> CGAAGTTTAGT
CCGATAAGAGC -> CGATAAGAGCA
CCGCCACAATT -> CGCCACAATTC
CCGCCAGCCAA -> CGCCAGCCAAA
CCGCGAGCCGG -> CGCGAGCCGGG
CCGCGGACCCT -> CGCGGACCCTT
CCGCGGAGCGT -> CGCGGAGCGTA
CCGCGGATTGC -> CGCGGATTGCG
CCGCGTGCGAA -> CGCGTGCGAAT
CCGCGTGGGCC -> CGCGTGGGCCC
CCGCTTCTATA -> CGCTTCTATAG
CCGGACCATGC -> CGGACCATGCG
CCGGACTGGCT -> CGGACTGGCTG
CCGGATGTGTC -> CGGATGTGTCA
CCGGGGACGTC -> CGGGGACGTCA
CCGGGGCAAGA -> CGGGGCAAGAC
CCGTATGCGCA -> CGTATGCGCAC
CCGTATGGGGT -> CGTATGGGGTC
CCGTGAATGAG -> CGTGAATGAGC
CCGTGACGCTG -> CGTGACGCTGT
CCGTGACTGTC -> CGTGACTGTCA
CCGTTGTCGTC -> CGTTGTCGTCG
CCTACGACACC -> CTACGACACCA
CCTACGATATG -> CTACGATATGA
CCTAGGGCTGC -> CTAGGGCTGCT
CCTATGCAGAC -> CTATGCAGACG
CCTCGACTACT -> CTCGACTACTC
CCTGACGCCGC -> CTGACGCCGCG
CCTGCACTCTT -> CTGCACTCTTA
CCTGGGACTAA -> CTGGGACTAAG
CCTGTAGAGAG -> CTGTAGAGAGC
CCTGTCAATCC -> CTGTCAATCCA
CCTGTCCCCGT -> CTGTCCCCGTT
CCTGTCTAGGA -> CTGTCTAGGAC
CCTTAATTAAG -> CTTAATTAAGA
CCTTATACATC -> CTTATACATCC
CCTTCGTAGCA -> CTTCGTAGCAG
CCTTCTAAAAA -> CTTCTAAAAAT
CCTTGCAGGCA -> CTTGCAGGCAC
CCTTTCTGCTT -> CTTTCTGCTTC
CGAACACCCAC -> GAACACCCACT
CGAAGTTTAGT -> GAAGTTTAGTA
CGAATCGTACT -> GAATCGTACTC
CGACAACACTC -> GACAACACTCG
CGACAAGCGCA -> GACAAGCGCAT
CGACACCAACG -> GACACCAACGT
CGACTACTCGA -> GACTACTCGAT
CGACTCGGGGA -> GACTCGGGGAT
CGAGACCGCGT -> GAGACCGCGTG
CGAGAGTTTGT -> GAGAGTTTGTT
CGAGCCGGGGA -> GAGCCGGGGAC
CGAGCGGCAGA -> GAGCGGCAGAC
CGAGCTGGTGT -> GAGCTGGTGTC
CGAGGACGGGC -> GAGGACGGGCA
CGATAAGAGCA -> GATAAGAGCAG
CGATACTATTT -> GATACTATTTG
CGATATGAAGA -> GATATGAAGAT
CGATGCTCTTT -> GATGCTCTTTC
CGATGGGACAA -> GATGGGACAAA
CGATTCGTCAT -> GATTCGTCATG
CGATTGCCATC -> GATTGCCATCT
CGATTTCCCCA -> GATTTCCCCAC
CGCAAATCCGC -> GCAAATCCGCT
CGCAAGGAGAA -> GCAAGGAGAAT
CGCAATCCACA -> GCAATCCACAC
CGCACACGACA -> GCACACGACAA
CGCACTCGCTG -> GCACTCGCTGA
CGCAGGAAACG -> GCAGGAAACGA
CGCAGTAAAGG -> GCAGTAAAGGA
CGCATCCTGGG -> GCATCCTGGGA
CGCCACAATTC -> GCCACAATTCC
CGCCAGCCAAA -> GCCAGCCAAAA
CGCCCTTCGTA -> GCCCTTCGTAG
CGCCGCGTGCG -> GCCGCGTGCGA
CGCGAGCCGGG -> GCGAGCCGGGG
CGCGCTGTTGA -> GCGCTGTTGAC
CGCGGACCCTT -> GCGGACCCTTT
CGCGGAGCGTA -> GCGGAGCGTAC
CGCGGATTGCG -> GCGGATTGCGT
CGCGGTCAGAG -> GCGGTCAGAGG
CGCGGTTTTGT -> GCGGTTTTGTG
CGCGTGCGAAT -> GCGTGCGAATC
CGCGTGGGCCC -> GCGTGGGCCCT
CGCGTTGTTTT -> GCGTTGTTTTA
CGCGTTTGCAA -> GCGTTTGCAAG
CGCTAGGCCTG -> GCTAGGCCTGT
CGCTGAGTTTA -> GCTGAGTTTAC
CGCTGTTGACG -> GCTGTTGACGT
CGCTGTTTGAA -> GCTGTTTGAAT
CGCTTACTATT -> GCTTACTATTA
CGCTTCTATAG -> GCTTCTATAGG
CGCTTTTGGCC -> GCTTTTGGCCA
CGGACCATGCG -> GGACCATGCGC
CGGACCCTTTC -> GGACCCTTTCT
CGGACTGGCTG -> GGACTGGCTGA
CGGAGCGTACT -> GGAGCGTACTG
CGGAGTTTCCG -> GGAGTTTCCGT
CGGATGTGTCA -> GGATGTGTCAA
CGGATTGCGTG -> GGATTGCGTGG
CGGCAGACGTA -> GGCAGACGTAG
CGGCCGCGAGC -> GGCCGCGAGCC
CGGCGTCACCG -> GGCGTCACCGC
CGGCTACTTTT -> GGCTACTTTTT
CGGCTTCGAGA -> GGCTTCGAGAC
CGGGACATTGC -> GGGACATTGCG
CGGGATCAGCC -> GGGATCAGCCT
CGGGCAAAAAA -> GGGCAAAAAAC
CGGGCACATTT -> GGGCACATTTA
CGGGCACCGGA -> GGGCACCGGAC
CGGGGACGTCA -> GGGGACGTCAA
CGGGGATTCTA -> GGGGATTCTAA
CGGGGCAAGAC -> GGGGCAAGACC
CGGGTACAATG -> GGGTACAATGG
CGGTCAGAGGC -> GGTCAGAGGCT
CGGTCTACAAC -> GGTCTACAACT
CGGTCTGTCAT -> GGTCTGTCATG
CGGTGTCACTG -> GGTGTCACTGA
CGGTTAGATAG -> GGTTAGATAGT
CGGTTTGGACC -> GGTTTGGACCG
CGGTTTTGTGT -> GGTTTTGTGTC
CGTAAAGTCGG -> GTAAAGTCGGC
CGTAACGCAAG -> GTAACGCAAGG
CGTAATTTATG -> GTAATTTATGG
CGTACCCGCCA -> GTACCCGCCAG
CGTACTCGGTT -> GTACTCGGTTT
CGTACTGACAT -> GTACTGACATA
CGTAGACAAGA -> GTAGACAAGAT
CGTAGCAGCTC -> GTAGCAGCTCG
CGTAGTGGCGG -> GTAGTGGCGGC
CGTATGCGCAC -> GTATGCGCACT
CGTATGGGGTC -> GTATGGGGTCT
CGTCAAACCGT -> GTCAAACCGTA
CGTCACCGCGG -> GTCACCGCGGA
CGTCATGCCTG -> GTCATGCCTGA
CGTCGTGGATC -> GTCGTGGATCA
CGTCTTATAGC -> GTCTTATAGCG
CGTGAATGAGC -> GTGAATGAGCG
CGTGACGCTGT -> GTGACGCTGTT
CGTGACTGTCA -> GTGACTGTCAT
CGTGCGAATCG -> GTGCGAATCGT
CGTGCGTAATT -> GTGCGTAATTT
CGTGGAGTAAA -> GTGGAGTAAAC
CGTGGATCAAG -> GTGGATCAAGT
CGTGGGCCCAG -> GTGGGCCCAGC
CGTGGGCCCTT -> GTGGGCCCTTC
CGTGTAGGATA -> GTGTAGGATAA
CGTTATGGGAC -> GTTATGGGACC
CGTTGCAGCCA -> GTTGCAGCCAC
CGTTGCCAAAG -> GTTGCCAAAGT
CGTTGGCGGTT -> GTTGGCGGTTA
CGTTGTCGTCG -> GTTGTCGTCGT
CGTTGTGTGTC -> GTTGTGTGTCT
CGTTGTTTTAC -> GTTGTTTTACG
CGTTTGCAAGC -> GTTTGCAAGCC
CTAAAAATCGC -> TAAAAATCGCG
CTAAGCTATGG -> TAAGCTATGGT
CTAAGGCCGCC -> TAAGGCCGCCA
CTAATAGACCG -> TAATAGACCGA
CTAATGGCATA -> TAATGGCATAA
CTAATGGCATG -> TAATGGCATGC
CTACAACTAGC -> TACAACTAGCG
CTACGACACCA -> TACGACACCAA
CTACGATATGA -> TACGATATGAA
CTACTAGGGTC -> TACTAGGGTCA
CTACTCGATAC -> TACTCGATACT
CTACTGATATA -> TACTGATATAT
CTACTTGTCGC -> TACTTGTCGCA
CTACTTTTTAG -> TACTTTTTAGA
CTAGACTGTAG -> TAGACTGTAGT
CTAGCGTTATG -> TAGCGTTATGG
CTAGCTTGTGT -> TAGCTTGTGTG
CTAGGACCCAG -> TAGGACCCAGC
CTAGGCCGGAC -> TAGGCCGGACC
CTAGGCCTGTC -> TAGGCCTGTCC
CTAGGGCTGCT -> TAGGGCTGCTC
CTAGGGTCACA -> TAGGGTCACAT
CTAGTTAATCT -> TAGTTAATCTT
CTATAGGGAGG -> TATAGGGAGGT
CTATGCAGACG -> TATGCAGACGC
CTATGGTATCG -> TATGGTATCGT
CTATTAAGAGG -> TATTAAGAGGC
CTATTTGATCT -> TATTTGATCTA
CTCACAATTCG -> TCACAATTCGG
CTCAGCGTAAA -> TCAGCGTAAAG
CTCATCAGGGC -> TCATCAGGGCC
CTCCATCACGA -> TCCATCACGAA
CTCCTAGGGCT -> TCCTAGGGCTG
CTCGACTACTC -> TCGACTACTCG
CTCGATACTAT -> TCGATACTATT
CTCGATGGGAC -> TCGATGGGACA
CTCGCAGTAAA -> TCGCAGTAAAG
CTCGCTGAGTT -> TCGCTGAGTTT
CTCGGGGATTC -> TCGGGGATTCT
CTCGGTTTGGA -> TCGGTTTGGAC
CTCGTGCGTAA -> TCGTGCGTAAT
CTCTCCATCAC -> TCTCCATCACG
CTCTTAGTCGC -> TCTTAGTCGCG
CTCTTCGTCTT -> TCTTCGTCTTA
CTCTTTCCTTG -> TCTTTCCTTGC
CTGAAGAACGA -> TGAAGAACGAG
CTGACATACTG -> TGACATACTGA
CTGACATAGAA -> TGACATAGAAA
CTGACGCCGCG -> TGACGCCGCGT
CTGAGGTCACC -> TGAGGTCACCA
CTGAGGTTTCG -> TGAGGTTTCGC
CTGAGTTTACG -> TGAGTTTACGA
CTGATATATGT -> TGATATATGTG
CTGCACTCTTA -> TGCACTCTTAG
CTGCCTTAATT -> TGCCTTAATTA
CTGCGGGACAT -> TGCGGGACATT
CTGCTCAGCGT -> TGCTCAGCGTA
CTGCTTCAACT -> TGCTTCAACTT
CTGGCCGCGGA -> TGGCCGCGGAC
CTGGCTCTCCA -> TGGCTCTCCAT
CTGGCTGAGGT -> TGGCTGAGGTC,TGGCTGAGGTT
CTGGGACTAAG -> TGGGACTAAGG
CTGGTGTCGAC -> TGGTGTCGACA
CTGTAGAGAGC -> TGTAGAGAGCT
CTGTAGTGGCG -> TGTAGTGGCGC
CTGTATAGACC -> TGTATAGACCG
CTGTCAATCCA -> TGTCAATCCAT
CTGTCATCTAG -> TGTCATCTAGA
CTGTCATGCCC -> TGTCATGCCCC
CTGTCCCCGTT -> TGTCCCCGTTG
CTGTCTAGGAC -> TGTCTAGGACC
CTGTTGACGTG -> TGTTGACGTGG
CTGTTTGAATT -> TGTTTGAATTC
CTTAAACATGC -> TTAAACATGCT
CTTAATTAAGA -> TTAATTAAGAG
CTTACTATTAA -> TTACTATTAAG
CTTAGTCGCGG -> TTAGTCGCGGT
CTTATACATCC -> TTATACATCCA
CTTATAGCGGT -> TTATAGCGGTC
CTTATGATCGG -> TTATGATCGGC
CTTATTGGAAT -> TTATTGGAATC
CTTCAACTTCC -> TTCAACTTCCA
CTTCCACGACT -> TTCCACGACTC
CTTCCCCGGGG -> TTCCCCGGGGC
CTTCCTACGAT -> TTCCTACGATA
CTTCGAGACCG -> TTCGAGACCGC
CTTCGTAGCAG -> TTCGTAGCAGC
CTTCGTCTTAT -> TTCGTCTTATA
CTTCTAAAAAT -> TTCTAAAAATC
CTTCTATAGGG -> TTCTATAGGGA
CTTGACCTGTC -> TTGACCTGTCT
CTTGCAGGCAC -> TTGCAGGCACC
CTTGCGTGTAG -> TTGCGTGTAGG
CTTGTCGCAAT -> TTGTCGCAATC
CTTGTGTGCTC -> TTGTGTGCTCA
CTTTCCTTGCA -> TTTCCTTGCAG
CTTTCTGCTTC -> TTTCTGCTTCA
CTTTTGGCCAC -> TTTTGGCCACA
CTTTTTAGAGC -> TTTTTAGAGCG
GAAACAGGGTA -> AAACAGGGTAA
GAAACGAGAGT -> AAACGAGAGTT
GAAAGTCAGTC -> AAAGTCAGTCC
GAACACCCACT -> AACACCCACTA
GAACGAGCTGG -> AACGAGCTGGT
GAACGTAGTGG -> AACGTAGTGGC
GAAGAACGAGC -> AAGAACGAGCT
GAAGATAGACT -> AAGATAGACTC
GAAGTTTAGTA -> AAGTTTAGTAC
GAATCAAATCG -> AATCAAATCGG
GAATCGTACTC -> AATCGTACTCG
GAATCTCGCAG -> AATCTCGCAGT
GAATGAGCGAT -> AATGAGCGATT
GAATGTCAGTT -> AATGTCAGTTA
GAATTCCGAAG -> AATTCCGAAGT
GAATTTCGGGC -> AATTTCGGGCA
GACAAAACTGG -> ACAAAACTGGC
GACAACACTCG -> ACAACACTCGA
GACAAGAGAGG -> ACAAGAGAGGC
GACAAGATCAA -> ACAAGATCAAT
GACAAGCGCAT -> ACAAGCGCATC
GACACCAACGT -> ACACCAACGTT
GACATACTGAC -> ACATACTGACA
GACATAGAAAC -> ACATAGAAACA
GACATTGCGCA -> ACATTGCGCAG
GACCAACTGGC -> ACCAACTGGCC
GACCATGCGCT -> ACCATGCGCTA
GACCCAGCGCG -> ACCCAGCGCGT
GACCCTTTCTG -> ACCCTTTCTGC
GACCGATAAGA -> ACCGATAAGAG
GACCGCGGATT -> ACCGCGGATTG
GACCGCGTGGG -> ACCGCGTGGGC
GACCGTGACTG -> ACCGTGACTGT
GACCTACGACA -> ACCTACGACAC
GACCTGTCTAG -> ACCTGTCTAGG
GACGCACACGA -> ACGCACACGAC
GACGCCGCGTG -> ACGCCGCGTGC
GACGCTGTTTG -> ACGCTGTTTGA
GACGCTTACTA -> ACGCTTACTAT
GACGGGCAAAA -> ACGGGCAAAAA
GACGTAGACAA -> ACGTAGACAAG
GACGTCAAACC -> ACGTCAAACCG
GACGTGGGCCC -> ACGTGGGCCCA
GACTAAGGCCG -> ACTAAGGCCGC
GACTACTCGAT -> ACTACTCGATA
GACTCACAATT -> ACTCACAATTC
GACTCGGGGAT -> ACTCGGGGATT
GACTCTTCGTC -> ACTCTTCGTCT
GACTGGCTGAG -> ACTGGCTGAGG
GACTGTAGTGG -> ACTGTAGTGGC
GACTGTCATCT -> ACTGTCATCTA
GAGAATCAAAT -> AGAATCAAATC
GAGACAAGAGA -> AGACAAGAGAG
GAGACCGCGTG -> AGACCGCGTGG
GAGAGCTGGCT -> AGAGCTGGCTG
GAGAGGCCCTG -> AGAGGCCCTGT
GAGAGTTTGTT -> AGAGTTTGTTA
GAGCAGTATTA -> AGCAGTATTAC
GAGCCGGATGT -> AGCCGGATGTG
GAGCCGGGGAC -> AGCCGGGGACG
GAGCGATTGCC -> AGCGATTGCCA
GAGCGCGTTTG -> AGCGCGTTTGC
GAGCGGCAGAC -> AGCGGCAGACG
GAGCGGGATCA -> AGCGGGATCAG
GAGCGTACTGA -> AGCGTACTGAC
GAGCTGGCTGA -> AGCTGGCTGAG
GAGCTGGTGTC -> AGCTGGTGTCG
GAGCTTGACCT -> AGCTTGACCTG
GAGGACGGGCA -> AGGACGGGCAA
GAGGCAAGTGT -> AGGCAAGTGTT
GAGGCCCTGTA -> AGGCCCTGTAG
GAGGCTTAAAC -> AGGCTTAAACA
GAGGTACTTAT -> AGGTACTTATG
GAGGTCACCAA -> AGGTCACCAAG
GAGGTTTCGCG -> AGGTTTCGCGC
GAGTAAACCTC -> AGTAAACCTCG
GAGTCGGGTAC -> AGTCGGGTACA
GAGTTTACGAG -> AGTTTACGAGC
GAGTTTCCGTA -> AGTTTCCGTAT
GAGTTTGTTAC -> AGTTTGTTACT
GATAAAATCGT -> ATAAAATCGTA
GATAAGAGCAG -> ATAAGAGCAGT
GATACTATTTG -> ATACTATTTGA
GATAGACTCAC -> ATAGACTCACA
GATAGTTACAT -> ATAGTTACATG
GATAGTTGTCC -> ATAGTTGTCCC
GATATATGTGG -> ATATATGTGGA
GATATGAAGAT -> ATATGAAGATA
GATCAAGTAAT -> ATCAAGTAATC
GATCAATTTGT -> ATCAATTTGTC
GATCAGCCTAT -> ATCAGCCTATG
GATCGGCCGCG -> ATCGGCCGCGA
GATCTAATAGA -> ATCTAATAGAC
GATCTCCTAGG -> ATCTCCTAGGG
GATGCTCTTTC -> ATGCTCTTTCC
GATGGGACAAA -> ATGGGACAAAA
GATGTGTCAAC -> ATGTGTCAACG
GATTCGTCATG -> ATTCGTCATGC
GATTCTAAGCT -> ATTCTAAGCTA
GATTGCCATCT -> ATTGCCATCTA
GATTGCGTGGA -> ATTGCGTGGAG
GATTTCCCCAC -> ATTTCCCCACG
GCAAAAAACCC -> CAAAAAACCCA
GCAAATCCGCT -> CAAATCCGCTT
GCAAGACCAAC -> CAAGACCAACT
GCAAGCCTGTC -> CAAGCCTGTCA
GCAAGGAGAAT -> CAAGGAGAATC
GCAAGTGTTAC -> CAAGTGTTACT
GCAAGTTGGTA -> CAAGTTGGTAT
GCAATCCACAC -> CAATCCACACC
GCACACGACAA -> CACACGACAAC
GCACATTTACG -> CACATTTACGG
GCACCACGTAC -> CACCACGTACC
GCACCGGACTG -> CACCGGACTGG
GCACGTTGGCG -> CACGTTGGCGG
GCACTCGCTGA -> CACTCGCTGAG
GCACTCTTAGT -> CACTCTTAGTC
GCAGACGCTTA -> CAGACGCTTAC
GCAGACGTAGA -> CAGACGTAGAC
GCAGCCACAAA -> CAGCCACAAAT
GCAGCTCGTGC -> CAGCTCGTGCG
GCAGGAAACGA -> CAGGAAACGAG
GCAGGCACCAC -> CAGGCACCACG
GCAGTAAAGGA -> CAGTAAAGGAG
GCAGTATTACG -> CAGTATTACGG
GCATAATATCT -> CATAATATCTC
GCATCCTGGGA -> CATCCTGGGAC
GCATGCCCGTG -> CATGCCCGTGA
GCCAAAATTGG -> CCAAAATTGGC
GCCAAAGTGAA -> CCAAAGTGAAC
GCCACAAATAA -> CCACAAATAAA
GCCACAATTCC -> CCACAATTCCC
GCCACAGATAG -> CCACAGATAGT
GCCAGCCAAAA -> CCAGCCAAAAT
GCCATCTAGGC -> CCATCTAGGCC
GCCCAGCTAGC -> CCCAGCTAGCT
GCCCATTTTCT -> CCCATTTTCTT
GCCCCTGCACT -> CCCCTGCACTC
GCCCGTGACGC -> CCCGTGACGCT
GCCCTGTAGAG -> CCCTGTAGAGA
GCCCTTCGTAG -> CCCTTCGTAGC
GCCCTTCTAAA -> CCCTTCTAAAA
GCCGCCACAAT -> CCGCCACAATT
GCCGCGAGCCG -> CCGCGAGCCGG
GCCGCGGACCC -> CCGCGGACCCT
GCCGCGTGCGA -> CCGCGTGCGAA
GCCGGACCATG -> CCGGACCATGC
GCCGGATGTGT -> CCGGATGTGTC
GCCGGGGACGT -> CCGGGGACGTC
GCCTATGCAGA -> CCTATGCAGAC
GCCTGACGCCG -> CCTGACGCCGC
GCCTGTCAATC -> CCTGTCAATCC
GCCTGTCCCCG -> CCTGTCCCCGT
GCCTTAATTAA -> CCTTAATTAAG
GCGAATCGTAC -> CGAATCGTACT
GCGAGCCGGGG -> CGAGCCGGGGA
GCGATTGCCAT -> CGATTGCCATC
GCGATTTCCCC -> CGATTTCCCCA
GCGCAAATCCG -> CGCAAATCCGC
GCGCACTCGCT -> CGCACTCGCTG
GCGCAGGAAAC -> CGCAGGAAACG
GCGCATCCTGG -> CGCATCCTGGG
GCGCGTTGTTT -> CGCGTTGTTTT
GCGCGTTTGCA -> CGCGTTTGCAA
GCGCTAGGCCT -> CGCTAGGCCTG
GCGCTGTTGAC -> CGCTGTTGACG
GCGGACCCTTT -> CGGACCCTTTC
GCGGAGCGTAC -> CGGAGCGTACT
GCGGATTGCGT -> CGGATTGCGTG
GCGGCAGACGT -> CGGCAGACGTA
GCGGCTTCGAG -> CGGCTTCGAGA
GCGGGACATTG -> CGGGACATTGC
GCGGGATCAGC -> CGGGATCAGCC
GCGGTCAGAGG -> CGGTCAGAGGC
GCGGTCTGTCA -> CGGTCTGTCAT
GCGGTTAGATA -> CGGTTAGATAG
GCGGTTTTGTG -> CGGTTTTGTGT
GCGTAAAGTCG -> CGTAAAGTCGG
GCGTAATTTAT -> CGTAATTTATG
GCGTACTGACA -> CGTACTGACAT
GCGTCACCGCG -> CGTCACCGCGG
GCGTGCGAATC -> CGTGCGAATCG
GCGTGGAGTAA -> CGTGGAGTAAA
GCGTGGGCCCT -> CGTGGGCCCTT
GCGTGTAGGAT -> CGTGTAGGATA
GCGTTATGGGA -> CGTTATGGGAC
GCGTTGTTTTA -> CGTTGTTTTAC
GCGTTTGCAAG -> CGTTTGCAAGC
GCTACTTTTTA -> CTACTTTTTAG
GCTAGCTTGTG -> CTAGCTTGTGT
GCTAGGCCTGT -> CTAGGCCTGTC
GCTATGGTATC -> CTATGGTATCG
GCTCAGCGTAA -> CTCAGCGTAAA
GCTCGTGCGTA -> CTCGTGCGTAA
GCTCTCCATCA -> CTCTCCATCAC
GCTCTTTCCTT -> CTCTTTCCTTG
GCTGAGGTCAC -> CTGAGGTCACC
GCTGAGGTTTC -> CTGAGGTTTCG
GCTGAGTTTAC -> CTGAGTTTACG
GCTGCTCAGCG -> CTGCTCAGCGT
GCTGGCTGAGG -> CTGGCTGAGGT
GCTGGTGTCGA -> CTGGTGTCGAC
GCTGTATAGAC -> CTGTATAGACC
GCTGTTGACGT -> CTGTTGACGTG
GCTGTTTGAAT -> CTGTTTGAATT
GCTTAAACATG -> CTTAAACATGC
GCTTACTATTA -> CTTACTATTAA
GCTTCAACTTC -> CTTCAACTTCC
GCTTCGAGACC -> CTTCGAGACCG
GCTTCTATAGG -> CTTCTATAGGG
GCTTGACCTGT -> CTTGACCTGTC
GCTTGTGTGCT -> CTTGTGTGCTC
GCTTTTGGCCA -> CTTTTGGCCAC
GGAAACGAGAG -> GAAACGAGAGT
GGAATCTCGCA -> GAATCTCGCAG
GGAATGTCAGT -> GAATGTCAGTT
GGAATTTCGGG -> GAATTTCGGGC
GGACAAAACTG -> GACAAAACTGG
GGACATTGCGC -> GACATTGCGCA
GGACCATGCGC -> GACCATGCGCT
GGACCCAGCGC -> GACCCAGCGCG
GGACCCTTTCT -> GACCCTTTCTG
GGACCGTGACT -> GACCGTGACTG
GGACCTACGAC -> GACCTACGACA
GGACGGGCAAA -> GACGGGCAAAA
GGACGTCAAAC -> GACGTCAAACC
GGACTAAGGCC -> GACTAAGGCCG
GGACTGGCTGA -> GACTGGCTGAG
GGAGAATCAAA -> GAGAATCAAAT
GGAGACAAGAG -> GAGACAAGAGA
GGAGCCGGATG -> GAGCCGGATGT
GGAGCGTACTG -> GAGCGTACTGA
GGAGGTACTTA -> GAGGTACTTAT
GGAGTAAACCT -> GAGTAAACCTC
GGAGTTTCCGT -> GAGTTTCCGTA
GGATAAAATCG -> GATAAAATCGT
GGATCAAGTAA -> GATCAAGTAAT
GGATCAGCCTA -> GATCAGCCTAT
GGATGTGTCAA -> GATGTGTCAAC
GGATTCTAAGC -> GATTCTAAGCT
GGATTGCGTGG -> GATTGCGTGGA
GGCAAAAAACC -> GCAAAAAACCC
GGCAAGACCAA -> GCAAGACCAAC
GGCAAGTGTTA -> GCAAGTGTTAC
GGCAAGTTGGT -> GCAAGTTGGTA
GGCACATTTAC -> GCACATTTACG
GGCACCACGTA -> GCACCACGTAC
GGCACCGGACT -> GCACCGGACTG
GGCAGACGTAG -> GCAGACGTAGA
GGCATAATATC -> GCATAATATCT
GGCATGCCCGT -> GCATGCCCGTG
GGCCACAGATA -> GCCACAGATAG
GGCCCAGCTAG -> GCCCAGCTAGC
GGCCCATTTTC -> GCCCATTTTCT
GGCCCTGTAGA -> GCCCTGTAGAG
GGCCCTTCTAA -> GCCCTTCTAAA
GGCCGCCACAA -> GCCGCCACAAT
GGCCGCGAGCC -> GCCGCGAGCCG
GGCCGCGGACC -> GCCGCGGACCC
GGCCGGACCAT -> GCCGGACCATG
GGCCTGTCCCC -> GCCTGTCCCCG
GGCGCAAATCC -> GCGCAAATCCG
GGCGGCTTCGA -> GCGGCTTCGAG
GGCGGTTAGAT -> GCGGTTAGATA
GGCGTCACCGC -> GCGTCACCGCG
GGCTACTTTTT -> GCTACTTTTTA
GGCTCTCCATC -> GCTCTCCATCA
GGCTGAGGTCA -> GCTGAGGTCAC
GGCTGAGGTTT -> GCTGAGGTTTC
GGCTGCTCAGC -> GCTGCTCAGCG
GGCTTAAACAT -> GCTTAAACATG
GGCTTCGAGAC -> GCTTCGAGACC
GGGACAAAACT -> GGACAAAACTG
GGGACATTGCG -> GGACATTGCGC
GGGACCTACGA -> GGACCTACGAC
GGGACGTCAAA -> GGACGTCAAAC
GGGACTAAGGC -> GGACTAAGGCC
GGGAGGTACTT -> GGAGGTACTTA
GGGATCAGCCT -> GGATCAGCCTA
GGGATTCTAAG -> GGATTCTAAGC
GGGCAAAAAAC -> GGCAAAAAACC
GGGCAAGACCA -> GGCAAGACCAA
GGGCACATTTA -> GGCACATTTAC
GGGCACCGGAC -> GGCACCGGACT
GGGCCCAGCTA -> GGCCCAGCTAG
GGGCCCATTTT -> GGCCCATTTTC
GGGCCCTTCTA -> GGCCCTTCTAA
GGGCTGCTCAG -> GGCTGCTCAGC
GGGGACGTCAA -> GGGACGTCAAA
GGGGATTCTAA -> GGGATTCTAAG
GGGGCAAGACC -> GGGCAAGACCA
GGGGTCTTATT -> GGGTCTTATTG
GGGTAAGCACG -> GGTAAGCACGT
GGGTACAATGG -> GGTACAATGGG
GGGTCACATTG -> GGTCACATTGA
GGGTCTTATTG -> GGTCTTATTGG
GGGTTAACGCT -> GGTTAACGCTT
GGTAAGCACGT -> GTAAGCACGTT
GGTACAATGGG -> GTACAATGGGT
GGTACTTATGA -> GTACTTATGAT
GGTATCGTTGC -> GTATCGTTGCC
GGTATGATCTC -> GTATGATCTCC
GGTCACATTGA -> GTCACATTGAG
GGTCACCAAGA -> GTCACCAAGAA
GGTCAGAGGCT -> GTCAGAGGCTT
GGTCTACAACT -> GTCTACAACTA
GGTCTGTCATG -> GTCTGTCATGC
GGTCTTATTGG -> GTCTTATTGGA
GGTGACTCTTC -> GTGACTCTTCG
GGTGTCACTGA -> GTGTCACTGAA
GGTGTCGACAA -> GTGTCGACAAG
GGTTAACGCTT -> GTTAACGCTTT
GGTTAGATAGT -> GTTAGATAGTT
GGTTGGAGCCG -> GTTGGAGCCGG
GGTTTCGCGCT -> GTTTCGCGCTG
GGTTTGGACCG -> GTTTGGACCGT
GGTTTTGTGTC -> GTTTTGTGTCT
GTAAACCTCGA -> TAAACCTCGAC
GTAAAGGAGAC -> TAAAGGAGACA
GTAAAGTCGGC -> TAAAGTCGGCG
GTAACGCAAGG -> TAACGCAAGGA
GTAAGCACGTT -> TAAGCACGTTG
GTAATCGTTGT -> TAATCGTTGTG
GTAATTTATGG -> TAATTTATGGT
GTACAATGGGT -> TACAATGGGTT
GTACCCGCCAG -> TACCCGCCAGC
GTACGGTGTCA -> TACGGTGTCAC
GTACTCGGTTT -> TACTCGGTTTG
GTACTGACATA -> TACTGACATAC
GTACTTATGAT -> TACTTATGATC
GTAGACAAGAT -> TAGACAAGATC
GTAGAGAGCTG -> TAGAGAGCTGG
GTAGCAGCTCG -> TAGCAGCTCGT
GTAGGATAAAA -> TAGGATAAAAT
GTAGTGGCGCA -> TAGTGGCGCAA
GTAGTGGCGGC -> TAGTGGCGGCT
GTATAGACCGC -> TATAGACCGCG
GTATCGTTGCC -> TATCGTTGCCA
GTATGAGCTTG -> TATGAGCTTGA
GTATGATCTCC -> TATGATCTCCT
GTATGCGCACT -> TATGCGCACTC
GTATGGGGTCT -> TATGGGGTCTT
GTATTACGGAG -> TATTACGGAGT
GTCAAACCGTA -> TCAAACCGTAT
GTCAACGATGC -> TCAACGATGCT
GTCAATCCATA -> TCAATCCATAT
GTCACATTGAG -> TCACATTGAGT
GTCACCAAGAA -> TCACCAAGAAA
GTCACCGCGGA -> TCACCGCGGAG
GTCACTGAAGA -> TCACTGAAGAA
GTCAGAGGCTT -> TCAGAGGCTTA
GTCAGTCCGTG -> TCAGTCCGTGA
GTCAGTTAACT -> TCAGTTAACTA
GTCATCTAGAC -> TCATCTAGACT
GTCATGCCCCT -> TCATGCCCCTG
GTCATGCCTGA -> TCATGCCTGAC
GTCCAAAAACT -> TCCAAAAACTT
GTCCCCAAATA -> TCCCCAAATAA
GTCCCCGTTGT -> TCCCCGTTGTC
GTCCGTGAATG -> TCCGTGAATGA
GTCGACAAGCG -> TCGACAAGCGC
GTCGCAATCCA -> TCGCAATCCAC
GTCGCGGTCAG -> TCGCGGTCAGA
GTCGGCGTCAC -> TCGGCGTCACC
GTCGGGTACAA -> TCGGGTACAAT
GTCGTCGTGGA -> TCGTCGTGGAT
GTCGTGGATCA -> TCGTGGATCAA
GTCTACAACTA -> TCTACAACTAG
GTCTACTGATA -> TCTACTGATAT
GTCTACTTGTC -> TCTACTTGTCG
GTCTAGGACCC -> TCTAGGACCCA
GTCTGTCATGC -> TCTGTCATGCC
GTCTTATAGCG -> TCTTATAGCGG
GTCTTATTGGA -> TCTTATTGGAA
GTGAACGTAGT -> TGAACGTAGTG
GTGAATGAGCG -> TGAATGAGCGA
GTGACGCTGTT -> TGACGCTGTTT
GTGACTCTTCG -> TGACTCTTCGT
GTGACTGTCAT -> TGACTGTCATC
GTGCGAATCGT -> TGCGAATCGTA
GTGCGTAATTT -> TGCGTAATTTA
GTGCTCACGGT -> TGCTCACGGTT
GTGGAATTTCG -> TGGAATTTCGG
GTGGAGTAAAC -> TGGAGTAAACC
GTGGATCAAGT -> TGGATCAAGTA
GTGGCGCAAAT -> TGGCGCAAATC
GTGGCGGCTTC -> TGGCGGCTTCG
GTGGGCCCAGC -> TGGGCCCAGCT
GTGGGCCCTTC -> TGGGCCCTTCT
GTGTAGGATAA -> TGTAGGATAAA
GTGTCAACGAT -> TGTCAACGATG
GTGTCACTGAA -> TGTCACTGAAG
GTGTCGACAAG -> TGTCGACAAGC
GTGTCTACTGA -> TGTCTACTGAT
GTGTCTACTTG -> TGTCTACTTGT
GTGTGCTCACG -> TGTGCTCACGG
GTGTGTCTACT -> TGTGTCTACTG
GTGTTACTGCG -> TGTTACTGCGG
GTTAACGCTTT -> TTAACGCTTTT
GTTAACTAATG -> TTAACTAATGG
GTTAATCTTCC -> TTAATCTTCCT
GTTACATGTTC -> TTACATGTTCC
GTTACTAATGG -> TTACTAATGGC
GTTACTGCGGG -> TTACTGCGGGA
GTTAGATAGTT -> TTAGATAGTTA
GTTATGGGACC -> TTATGGGACCT
GTTCCTTATAC -> TTCCTTATACA
GTTGACGCACA -> TTGACGCACAC
GTTGACGTGGG -> TTGACGTGGGC
GTTGCAGCCAC -> TTGCAGCCACA
GTTGCCAAAGT -> TTGCCAAAGTG
GTTGGAGCCGG -> TTGGAGCCGGA
GTTGGCGGTTA -> TTGGCGGTTAG
GTTGGTATGAT -> TTGGTATGATC
GTTGGTTGGAG -> TTGGTTGGAGC
GTTGTCCCCAA -> TTGTCCCCAAA
GTTGTCGTCGT -> TTGTCGTCGTG
GTTGTGTGTCT -> TTGTGTGTCTA
GTTGTTTTACG -> TTGTTTTACGC
GTTTACGAGCG -> TTTACGAGCGG
GTTTAGGAATG -> TTTAGGAATGT
GTTTAGTACGG -> TTTAGTACGGT
GTTTCCGTATG -> TTTCCGTATGC
GTTTCGCGCTG -> TTTCGCGCTGT
GTTTGAATTCC -> TTTGAATTCCG
GTTTGCAAGCC -> TTTGCAAGCCT
GTTTGGACCGT -> TTTGGACCGTG
GTTTGTTACTA -> TTTGTTACTAA
GTTTTACGCCC -> TTTTACGCCCT
GTTTTGTGTCT -> TTTTGTGTCTA
TAAAAATCGCG -> AAAAATCGCGG
TAAAATCGTAA -> AAAATCGTAAC
TAAACATGCTG -> AAACATGCTGT
TAAACCTCGAC -> AAACCTCGACT
TAAAGGAGACA -> AAAGGAGACAA
TAAAGTATGAG -> AAAGTATGAGC
TAAAGTCGGCG -> AAAGTCGGCGT
TAACGCAAGGA -> AACGCAAGGAG
TAACGCTTTTG -> AACGCTTTTGG
TAACTAATGGC -> AACTAATGGCA
TAAGAGCAGTA -> AAGAGCAGTAT
TAAGAGCGGGA -> AAGAGCGGGAT
TAAGAGGCAAG -> AAGAGGCAAGT
TAAGCACGTTG -> AAGCACGTTGG
TAAGCTATGGT -> AAGCTATGGTA
TAAGGCCGCCA -> AAGGCCGCCAC
TAAGTTTAGGA -> AAGTTTAGGAA
TAATAGACCGA -> AATAGACCGAT
TAATATCTCAT -> AATATCTCATC
TAATCGTTGTG -> AATCGTTGTGT
TAATCTTCCTA -> AATCTTCCTAC
TAATGGCATAA -> AATGGCATAAT
TAATGGCATGC -> AATGGCATGCC
TAATTAAGAGC -> AATTAAGAGCG
TAATTTATGGT -> AATTTATGGTG
TACAACTAGCG -> ACAACTAGCGT
TACAATGGGTT -> ACAATGGGTTA
TACATCCAGCG -> ACATCCAGCGA
TACATGTTCCT -> ACATGTTCCTT
TACCCGCCAGC -> ACCCGCCAGCC
TACGACACCAA -> ACGACACCAAC
TACGAGCGGCA -> ACGAGCGGCAG
TACGATATGAA -> ACGATATGAAG
TACGCCCTTCG -> ACGCCCTTCGT
TACGGAGTTTC -> ACGGAGTTTCC
TACGGCTACTT -> ACGGCTACTTT
TACGGTGTCAC -> ACGGTGTCACT
TACTAATGGCA -> ACTAATGGCAT
TACTAGGGTCA -> ACTAGGGTCAC
TACTATTAAGA -> ACTATTAAGAG
TACTATTTGAT -> ACTATTTGATC
TACTCGATACT -> ACTCGATACTA
TACTCGGTTTG -> ACTCGGTTTGG
TACTGACATAC -> ACTGACATACT
TACTGACATAG -> ACTGACATAGA
TACTGATATAT -> ACTGATATATG
TACTGCGGGAC -> ACTGCGGGACA
TACTTATGATC -> ACTTATGATCG
TACTTGTCGCA -> ACTTGTCGCAA
TACTTTTTAGA -> ACTTTTTAGAG
TAGAAACAGGG -> AGAAACAGGGT
TAGACAAGATC -> AGACAAGATCA
TAGACCGATAA -> AGACCGATAAG
TAGACCGCGGA -> AGACCGCGGAT
TAGACTCACAA -> AGACTCACAAT
TAGACTGTAGT -> AGACTGTAGTG
TAGAGAGCTGG -> AGAGAGCTGGC
TAGAGCGCGTT -> AGAGCGCGTTT
TAGATAGTTAC -> AGATAGTTACA
TAGCAGCTCGT -> AGCAGCTCGTG
TAGCGGTCTGT -> AGCGGTCTGTC
TAGCGTTATGG -> AGCGTTATGGG
TAGCTTGTGTG -> AGCTTGTGTGC
TAGGAATGTCA -> AGGAATGTCAG
TAGGACCCAGC -> AGGACCCAGCG
TAGGATAAAAT -> AGGATAAAATC
TAGGCCGGACC -> AGGCCGGACCA
TAGGCCTGTCC -> AGGCCTGTCCC
TAGGGAGGTAC -> AGGGAGGTACT
TAGGGCTGCTC -> AGGGCTGCTCA
TAGGGTCACAT -> AGGGTCACATT
TAGTACGGTGT -> AGTACGGTGTC
TAGTCGCGGTC -> AGTCGCGGTCA
TAGTGGCGCAA -> AGTGGCGCAAA
TAGTGGCGGCT -> AGTGGCGGCTT
TAGTTAATCTT -> AGTTAATCTTC
TAGTTACATGT -> AGTTACATGTT
TAGTTGTCCCC -> AGTTGTCCCCA
TATACATCCAG -> ATACATCCAGC
TATAGACCGCG -> ATAGACCGCGG
TATAGCGGTCT -> ATAGCGGTCTG
TATAGGGAGGT -> ATAGGGAGGTA
TATATGTGGAA -> ATATGTGGAAT
TATCGTTGCCA -> ATCGTTGCCAA
TATCTCATCAG -> ATCTCATCAGG
TATCTGCCTTA -> ATCTGCCTTAA
TATGAAGATAG -> ATGAAGATAGA
TATGAGCTTGA -> ATGAGCTTGAC
TATGATCGGCC -> ATGATCGGCCG
TATGATCTCCT -> ATGATCTCCTA
TATGCAGACGC -> ATGCAGACGCT
TATGCGCACTC -> ATGCGCACTCG
TATGGGACCTA -> ATGGGACCTAC
TATGGGGTCTT -> ATGGGGTCTTA
TATGGTATCGT -> ATGGTATCGTT
TATGGTGACTC -> ATGGTGACTCT
TATGTGGAATT -> ATGTGGAATTT
TATGTTGGTTG -> ATGTTGGTTGG
TATTAAGAGGC -> ATTAAGAGGCA
TATTACGGAGT -> ATTACGGAGTT
TATTGGAATCT -> ATTGGAATCTC
TATTTGATCTA -> ATTTGATCTAA
TCAAACCGTAT -> CAAACCGTATG
TCAAATCGGGC -> CAAATCGGGCA
TCAACGATGCT -> CAACGATGCTC
TCAACTTCCAC -> CAACTTCCACG
TCAAGTAATCG -> CAAGTAATCGT
TCAATCCATAT -> CAATCCATATG
TCAATTTGTCC -> CAATTTGTCCA
TCACAATTCGG -> CACAATTCGGT
TCACATTGAGT -> CACATTGAGTC
TCACCAAGAAA -> CACCAAGAAAG
TCACCGCGGAG -> CACCGCGGAGC
TCACGAACACC -> CACGAACACCC
TCACGATTCGT -> CACGATTCGTC
TCACTGAAGAA -> CACTGAAGAAC
TCAGAGGCTTA -> CAGAGGCTTAA
TCAGCCTATGC -> CAGCCTATGCA
TCAGCGTAAAG -> CAGCGTAAAGT
TCAGGGCCCAT -> CAGGGCCCATT
TCAGTCCGTGA -> CAGTCCGTGAA
TCAGTTAACTA -> CAGTTAACTAA
TCATCAGGGCC -> CATCAGGGCCC
TCATCTAGACT -> CATCTAGACTG
TCATGCCCCTG -> CATGCCCCTGC
TCATGCCTGAC -> CATGCCTGACG
TCCAAAAACTT -> CCAAAAACTTC
TCCACACCATT -> CCACACCATTC
TCCACGACTCG -> CCACGACTCGG
TCCAGCGATTT -> CCAGCGATTTC
TCCATATGTTG -> CCATATGTTGG
TCCATCACGAA -> CCATCACGAAC
TCCCAATGTTG -> CCCAATGTTGA
TCCCCAAATAA -> CCCCAAATAAG
TCCCCACGAGG -> CCCCACGAGGA
TCCCCGGGGCA -> CCCCGGGGCAA
TCCCCGTTGTC -> CCCCGTTGTCG
TCCGAAGTTTA -> CCGAAGTTTAG
TCCGCTTCTAT -> CCGCTTCTATA
TCCGTATGCGC -> CCGTATGCGCA
TCCGTGAATGA -> CCGTGAATGAG
TCCTACGATAT -> CCTACGATATG
TCCTAGGGCTG -> CCTAGGGCTGC
TCCTGGGACTA -> CCTGGGACTAA
TCCTTATACAT -> CCTTATACATC
TCCTTGCAGGC -> CCTTGCAGGCA
TCGACAAGCGC -> CGACAAGCGCA
TCGACTACTCG -> CGACTACTCGA
TCGAGACCGCG -> CGAGACCGCGT
TCGATACTATT -> CGATACTATTT
TCGATGGGACA -> CGATGGGACAA
TCGCAATCCAC -> CGCAATCCACA
TCGCAGTAAAG -> CGCAGTAAAGG
TCGCGCTGTTG -> CGCGCTGTTGA
TCGCGGTCAGA -> CGCGGTCAGAG
TCGCGGTTTTG -> CGCGGTTTTGT
TCGCTGAGTTT -> CGCTGAGTTTA
TCGGCCGCGAG -> CGGCCGCGAGC
TCGGCGTCACC -> CGGCGTCACCG
TCGGGCACATT -> CGGGCACATTT
TCGGGCACCGG -> CGGGCACCGGA
TCGGGGATTCT -> CGGGGATTCTA
TCGGGTACAAT -> CGGGTACAATG
TCGGTCTACAA -> CGGTCTACAAC
TCGGTTTGGAC -> CGGTTTGGACC
TCGTAACGCAA -> CGTAACGCAAG
TCGTACTCGGT -> CGTACTCGGTT
TCGTAGCAGCT -> CGTAGCAGCTC
TCGTCATGCCT -> CGTCATGCCTG
TCGTCGTGGAT -> CGTCGTGGATC
TCGTCTTATAG -> CGTCTTATAGC
TCGTGCGTAAT -> CGTGCGTAATT
TCGTGGATCAA -> CGTGGATCAAG
TCGTTGCCAAA -> CGTTGCCAAAG
TCGTTGTGTGT -> CGTTGTGTGTC
TCTAAAAATCG -> CTAAAAATCGC
TCTAAGCTATG -> CTAAGCTATGG
TCTAATAGACC -> CTAATAGACCG
TCTACAACTAG -> CTACAACTAGC
TCTACTGATAT -> CTACTGATATA
TCTACTTGTCG -> CTACTTGTCGC
TCTAGACTGTA -> CTAGACTGTAG
TCTAGGACCCA -> CTAGGACCCAG
TCTAGGCCGGA -> CTAGGCCGGAC
TCTATAGGGAG -> CTATAGGGAGG
TCTCATCAGGG -> CTCATCAGGGC
TCTCCATCACG -> CTCCATCACGA
TCTCCTAGGGC -> CTCCTAGGGCT
TCTCGCAGTAA -> CTCGCAGTAAA
TCTGCCTTAAT -> CTGCCTTAATT
TCTGCTTCAAC -> CTGCTTCAACT
TCTGTCATGCC -> CTGTCATGCCC
TCTTAGTCGCG -> CTTAGTCGCGG
TCTTATAGCGG -> CTTATAGCGGT
TCTTATTGGAA -> CTTATTGGAAT
TCTTCCTACGA -> CTTCCTACGAT
TCTTCGTCTTA -> CTTCGTCTTAT
TCTTGCGTGTA -> CTTGCGTGTAG
TCTTTCCTTGC -> CTTTCCTTGCA
TGAACGTAGTG -> GAACGTAGTGG
TGAAGAACGAG -> GAAGAACGAGC
TGAAGATAGAC -> GAAGATAGACT
TGAATGAGCGA -> GAATGAGCGAT
TGAATTCCGAA -> GAATTCCGAAG
TGACATACTGA -> GACATACTGAC
TGACATAGAAA -> GACATAGAAAC
TGACCTGTCTA -> GACCTGTCTAG
TGACGCACACG -> GACGCACACGA
TGACGCCGCGT -> GACGCCGCGTG
TGACGCTGTTT -> GACGCTGTTTG
TGACGTGGGCC -> GACGTGGGCCC
TGACTCTTCGT -> GACTCTTCGTC
TGACTGTCATC -> GACTGTCATCT
TGAGCGATTGC -> GAGCGATTGCC
TGAGCTTGACC -> GAGCTTGACCT
TGAGGTCACCA -> GAGGTCACCAA
TGAGGTTTCGC -> GAGGTTTCGCG
TGAGTCGGGTA -> GAGTCGGGTAC
TGAGTTTACGA -> GAGTTTACGAG
TGATATATGTG -> GATATATGTGG
TGATCGGCCGC -> GATCGGCCGCG
TGATCTAATAG -> GATCTAATAGA
TGATCTCCTAG -> GATCTCCTAGG
TGCAAGCCTGT -> GCAAGCCTGTC
TGCACTCTTAG -> GCACTCTTAGT
TGCAGACGCTT -> GCAGACGCTTA
TGCAGCCACAA -> GCAGCCACAAA
TGCAGGCACCA -> GCAGGCACCAC
TGCCAAAGTGA -> GCCAAAGTGAA
TGCCATCTAGG -> GCCATCTAGGC
TGCCCCTGCAC -> GCCCCTGCACT
TGCCCGTGACG -> GCCCGTGACGC
TGCCTGACGCC -> GCCTGACGCCG
TGCCTTAATTA -> GCCTTAATTAA
TGCGAATCGTA -> GCGAATCGTAC
TGCGCACTCGC -> GCGCACTCGCT
TGCGCAGGAAA -> GCGCAGGAAAC
TGCGCTAGGCC -> GCGCTAGGCCT
TGCGGGACATT -> GCGGGACATTG
TGCGTAATTTA -> GCGTAATTTAT
TGCGTGGAGTA -> GCGTGGAGTAA
TGCGTGTAGGA -> GCGTGTAGGAT
TGCTCACGGTT -> GCTCACGGTTG
TGCTCAGCGTA -> GCTCAGCGTAA
TGCTCTTTCCT -> GCTCTTTCCTT
TGCTGTATAGA -> GCTGTATAGAC
TGCTTCAACTT -> GCTTCAACTTC
TGGAATCTCGC -> GGAATCTCGCA
TGGAATTTCGG -> GGAATTTCGGG
TGGACCGTGAC -> GGACCGTGACT
TGGAGCCGGAT -> GGAGCCGGATG
TGGAGTAAACC -> GGAGTAAACCT
TGGATCAAGTA -> GGATCAAGTAA
TGGCAAGTTGG -> GGCAAGTTGGT
TGGCATAATAT -> GGCATAATATC
TGGCATGCCCG -> GGCATGCCCGT
TGGCCACAGAT -> GGCCACAGATA
TGGCCGCGGAC -> GGCCGCGGACC
TGGCGCAAATC -> GGCGCAAATCC
TGGCGGCTTCG -> GGCGGCTTCGA
TGGCGGTTAGA -> GGCGGTTAGAT
TGGCTCTCCAT -> GGCTCTCCATC
TGGCTGAGGTC -> GGCTGAGGTCA
TGGCTGAGGTT -> GGCTGAGGTTT
TGGGACAAAAC -> GGGACAAAACT
TGGGACCTACG -> GGGACCTACGA
TGGGACTAAGG -> GGGACTAAGGC
TGGGCCCAGCT -> GGGCCCAGCTA
TGGGCCCTTCT -> GGGCCCTTCTA
TGGGGTCTTAT -> GGGGTCTTATT
TGGGTTAACGC -> GGGTTAACGCT
TGGTATCGTTG -> GGTATCGTTGC
TGGTATGATCT -> GGTATGATCTC
TGGTGACTCTT -> GGTGACTCTTC
TGGTGTCGACA -> GGTGTCGACAA
TGGTTGGAGCC -> GGTTGGAGCCG
TGTAGAGAGCT -> GTAGAGAGCTG
TGTAGGATAAA -> GTAGGATAAAA
TGTAGTGGCGC -> GTAGTGGCGCA
TGTATAGACCG -> GTATAGACCGC
TGTCAACGATG -> GTCAACGATGC
TGTCAATCCAT -> GTCAATCCATA
TGTCACTGAAG -> GTCACTGAAGA
TGTCAGTTAAC -> GTCAGTTAACT
TGTCATCTAGA -> GTCATCTAGAC
TGTCATGCCCC -> GTCATGCCCCT
TGTCCAAAAAC -> GTCCAAAAACT
TGTCCCCAAAT -> GTCCCCAAATA
TGTCCCCGTTG -> GTCCCCGTTGT
TGTCGACAAGC -> GTCGACAAGCG
TGTCGCAATCC -> GTCGCAATCCA
TGTCGTCGTGG -> GTCGTCGTGGA
TGTCTACTGAT -> GTCTACTGATA
TGTCTACTTGT -> GTCTACTTGTC
TGTCTAGGACC -> GTCTAGGACCC
TGTGCTCACGG -> GTGCTCACGGT
TGTGGAATTTC -> GTGGAATTTCG
TGTGTCAACGA -> GTGTCAACGAT
TGTGTCTACTG -> GTGTCTACTGA
TGTGTCTACTT -> GTGTCTACTTG
TGTGTGCTCAC -> GTGTGCTCACG
TGTGTGTCTAC -> GTGTGTCTACT
TGTTACTAATG -> GTTACTAATGG
TGTTACTGCGG -> GTTACTGCGGG
TGTTCCTTATA -> GTTCCTTATAC
TGTTGACGCAC -> GTTGACGCACA
TGTTGACGTGG -> GTTGACGTGGG
TGTTGGTTGGA -> GTTGGTTGGAG
TGTTTGAATTC -> GTTTGAATTCC
TGTTTTACGCC -> GTTTTACGCCC
TTAAACATGCT -> TAAACATGCTG
TTAACGCTTTT -> TAACGCTTTTG
TTAACTAATGG -> TAACTAATGGC
TTAAGAGCGGG -> TAAGAGCGGGA
TTAAGAGGCAA -> TAAGAGGCAAG
TTAATCTTCCT -> TAATCTTCCTA
TTAATTAAGAG -> TAATTAAGAGC
TTACATGTTCC -> TACATGTTCCT
TTACGAGCGGC -> TACGAGCGGCA
TTACGCCCTTC -> TACGCCCTTCG
TTACGGAGTTT -> TACGGAGTTTC
TTACGGCTACT -> TACGGCTACTT
TTACTAATGGC -> TACTAATGGCA
TTACTATTAAG -> TACTATTAAGA
TTACTGCGGGA -> TACTGCGGGAC
TTAGAGCGCGT -> TAGAGCGCGTT
TTAGATAGTTA -> TAGATAGTTAC
TTAGGAATGTC -> TAGGAATGTCA
TTAGTACGGTG -> TAGTACGGTGT
TTAGTCGCGGT -> TAGTCGCGGTC
TTATACATCCA -> TATACATCCAG
TTATAGCGGTC -> TATAGCGGTCT
TTATGATCGGC -> TATGATCGGCC
TTATGGGACCT -> TATGGGACCTA
TTATGGTGACT -> TATGGTGACTC
TTATTGGAATC -> TATTGGAATCT
TTCAACTTCCA -> TCAACTTCCAC
TTCACGATTCG -> TCACGATTCGT
TTCCACGACTC -> TCCACGACTCG
TTCCCAATGTT -> TCCCAATGTTG
TTCCCCACGAG -> TCCCCACGAGG
TTCCCCGGGGC -> TCCCCGGGGCA
TTCCGAAGTTT -> TCCGAAGTTTA
TTCCGTATGCG -> TCCGTATGCGC
TTCCTACGATA -> TCCTACGATAT
TTCCTTATACA -> TCCTTATACAT
TTCCTTGCAGG -> TCCTTGCAGGC
TTCGAGACCGC -> TCGAGACCGCG
TTCGCGCTGTT -> TCGCGCTGTTG
TTCGGGCACAT -> TCGGGCACATT
TTCGGTCTACA -> TCGGTCTACAA
TTCGTAGCAGC -> TCGTAGCAGCT
TTCGTCATGCC -> TCGTCATGCCT
TTCGTCTTATA -> TCGTCTTATAG
TTCTAAAAATC -> TCTAAAAATCG
TTCTAAGCTAT -> TCTAAGCTATG
TTCTATAGGGA -> TCTATAGGGAG
TTCTGCTTCAA -> TCTGCTTCAAC
TTCTTGCGTGT -> TCTTGCGTGTA
TTGAATTCCGA -> TGAATTCCGAA
TTGACCTGTCT -> TGACCTGTCTA
TTGACGCACAC -> TGACGCACACG
TTGACGTGGGC -> TGACGTGGGCC
TTGAGTCGGGT -> TGAGTCGGGTA
TTGATCTAATA -> TGATCTAATAG
TTGCAAGCCTG -> TGCAAGCCTGT
TTGCAGCCACA -> TGCAGCCACAA
TTGCAGGCACC -> TGCAGGCACCA
TTGCCAAAGTG -> TGCCAAAGTGA
TTGCCATCTAG -> TGCCATCTAGG
TTGCGCAGGAA -> TGCGCAGGAAA
TTGCGTGGAGT -> TGCGTGGAGTA
TTGCGTGTAGG -> TGCGTGTAGGA
TTGGAATCTCG -> TGGAATCTCGC
TTGGACCGTGA -> TGGACCGTGAC
TTGGAGCCGGA -> TGGAGCCGGAT
TTGGCAAGTTG -> TGGCAAGTTGG
TTGGCCACAGA -> TGGCCACAGAT
TTGGCGGTTAG -> TGGCGGTTAGA
TTGGTATGATC -> TGGTATGATCT
TTGGTTGGAGC -> TGGTTGGAGCC
TTGTCCAAAAA -> TGTCCAAAAAC
TTGTCCCCAAA -> TGTCCCCAAAT
TTGTCGCAATC -> TGTCGCAATCC
TTGTCGTCGTG -> TGTCGTCGTGG
TTGTGTCTACT -> TGTGTCTACTT
TTGTGTGCTCA -> TGTGTGCTCAC
TTGTGTGTCTA -> TGTGTGTCTAC
TTGTTACTAAT -> TGTTACTAATG
TTGTTTTACGC -> TGTTTTACGCC
TTTACGAGCGG -> TTACGAGCGGC
TTTACGCCCTT -> TTACGCCCTTC
TTTACGGCTAC -> TTACGGCTACT
TTTAGAGCGCG -> TTAGAGCGCGT
TTTAGGAATGT -> TTAGGAATGTC
TTTAGTACGGT -> TTAGTACGGTG
TTTATGGTGAC -> TTATGGTGACT
TTTCCCCACGA -> TTCCCCACGAG
TTTCCGTATGC -> TTCCGTATGCG
TTTCCTTGCAG -> TTCCTTGCAGG
TTTCGCGCTGT -> TTCGCGCTGTT
TTTCGGGCACA -> TTCGGGCACAT
TTTCTGCTTCA -> TTCTGCTTCAA
TTTCTTGCGTG -> TTCTTGCGTGT
TTTGAATTCCG -> TTGAATTCCGA
TTTGATCTAAT -> TTGATCTAATA
TTTGCAAGCCT -> TTGCAAGCCTG
TTTGGACCGTG -> TTGGACCGTGA
TTTGGCCACAG -> TTGGCCACAGA
TTTGTCCAAAA -> TTGTCCAAAAA
TTTGTGTCTAC -> TTGTGTCTACT
TTTGTTACTAA -> TTGTTACTAAT
TTTTACGCCCT -> TTTACGCCCTT
TTTTAGAGCGC -> TTTAGAGCGCG
TTTTCTTGCGT -> TTTCTTGCGTG
TTTTGGCCACA -> TTTGGCCACAG
TTTTGTGTCTA -> TTTGTGTCTAC
TTTTTAGAGCG -> TTTTAGAGCGC
