Input
CTTCGTCCCATATTCATATGCTTG -> TTCGTCCCATATTCATATGCTTGC
GAAAACTAGAAGAGGCCCTTCTAT -> AAAACTAGAAGAGGCCCTTCTATC
CCTGAATCACCTCACTATTAGCCT -> CTGAATCACCTCACTATTAGCCTG
TTAATATCAGATGGTGGCACATTT -> TAATATCAGATGGTGGCACATTTT
GGTGTATCGTGCAGAAAGGGATCT -> GTGTATCGTGCAGAAAGGGATCTA
GTTGTCTAGATGGTTGATACAGTA -> TTGTCTAGATGGTTGATACAGTAT
ACGTGCCACATTTCATATATGCGG -> CGTGCCACATTTCATATATGCGGG
TAGAAGAGGCCCTTCTATCCAGTT -> AGAAGAGGCCCTTCTATCCAGTTG
AAGGCTGAACAGTGGCTCGGAATT -> AGGCTGAACAGTGGCTCGGAATTT
TTAACGCATCCCCAAAGGCTGAAC -> TAACGCATCCCCAAAGGCTGAACA
CCTTCTCAGGGTCTGGAACATGCT -> CTTCTCAGGGTCTGGAACATGCTG
GGACTATAAGGATAACGAGGCGTG -> GACTATAAGGATAACGAGGCGTGT
CACCCTCGCAATTAGGATCTGGAC -> ACCCTCGCAATTAGGATCTGGACC
ACGTCTACGGCCATGCTTCGGTCG -> CGTCTACGGCCATGCTTCGGTCGC
GTCTGTACCCGAGTGAAACGGCAG -> TCTGTACCCGAGTGAAACGGCAGC
CGGGCGAATACATACCTTGGCCTT -> GGGCGAATACATACCTTGGCCTTT
TATTCCTCCACCACAGAAAACTAG -> ATTCCTCCACCACAGAAAACTAGA
GCGGTTGTCTAGATGGTTGATACA -> CGGTTGTCTAGATGGTTGATACAG
GTCCCATATTCATATGCTTGCTGA -> TCCCATATTCATATGCTTGCTGAA
CTGGTGAGCCACGGCCGGCCATCC -> TGGTGAGCCACGGCCGGCCATCCA
GGGTCTGGAACATGCTGGACATTT -> GGTCTGGAACATGCTGGACATTTT
TACAGGGCCTAAGGCTATCGAAAA -> ACAGGGCCTAAGGCTATCGAAAAC
GTCTACGGCCATGCTTCGGTCGCA -> TCTACGGCCATGCTTCGGTCGCAT
TTTACAGGGCCTAAGGCTATCGAA -> TTACAGGGCCTAAGGCTATCGAAA
AAACTAGAAGAGGCCCTTCTATCC -> AACTAGAAGAGGCCCTTCTATCCA
AAACAGGAGTGACTGTCTATGATT -> AACAGGAGTGACTGTCTATGATTG
TGTATTCCTCCACCACAGAAAACT -> GTATTCCTCCACCACAGAAAACTA
CCGACAGAGTGCTTCCCTCTGTCA -> CGACAGAGTGCTTCCCTCTGTCAA
TATGCGGGTGCCCGGCCGCACCAC -> ATGCGGGTGCCCGGCCGCACCACG
TACCCCGACAGAGTGCTTCCCTCT -> ACCCCGACAGAGTGCTTCCCTCTG
AGCGACTCCCTACAGCGGCGTCGC -> GCGACTCCCTACAGCGGCGTCGCA
CTTTCACATCAAAAATCTTTCTTA -> TTTCACATCAAAAATCTTTCTTAA
AAGGTCATACAAAGAAGGGGAGCA -> AGGTCATACAAAGAAGGGGAGCAC
CATGATGCATCTTATCGTAACCGT -> ATGATGCATCTTATCGTAACCGTG
AACCGTGGTCTGTACCCGAGTGAA -> ACCGTGGTCTGTACCCGAGTGAAA
CACATCAAAAATCTTTCTTAAATA -> ACATCAAAAATCTTTCTTAAATAG
GGAAGAACGGCTGAACCTATATTC -> GAAGAACGGCTGAACCTATATTCA
GGATTGGTTCAAAAATAGAATACC -> GATTGGTTCAAAAATAGAATACCC
TGCCAACCTTGCTACAGCATTCCG -> GCCAACCTTGCTACAGCATTCCGC
GTGGCACATTTTAACGCATCCCCA -> TGGCACATTTTAACGCATCCCCAA
CTGAGTGGGACGCTCACAGCAGTA -> TGAGTGGGACGCTCACAGCAGTAT
TTTAGTGTGACCCGGGTGTTACTA -> TTAGTGTGACCCGGGTGTTACTAG
TGTTACTAGCGCAACTTCGAGTAA -> GTTACTAGCGCAACTTCGAGTAAC
ATTGGACCGTACCCCGACAGAGTG -> TTGGACCGTACCCCGACAGAGTGC
CGGCAGCAGCGACTCCCTACAGCG -> GGCAGCAGCGACTCCCTACAGCGG
GCTCTCGCTTACTTAACGTAACGA -> CTCTCGCTTACTTAACGTAACGAA
CCACGGACTATAAGGATAACGAGG -> CACGGACTATAAGGATAACGAGGC
ATCTGGTCCCCAAGCCCTCAGGCT -> TCTGGTCCCCAAGCCCTCAGGCTC
AGTGTGACCCGGGTGTTACTAGCG -> GTGTGACCCGGGTGTTACTAGCGC
ACTGACACATGCCAACCTTGCTAC -> CTGACACATGCCAACCTTGCTACA
ATCTCGTTTCCCTTTGAAAGGGCC -> TCTCGTTTCCCTTTGAAAGGGCCG
GCTCACAGCAGTATGGGTGTATCG -> CTCACAGCAGTATGGGTGTATCGT
TCCCAGGTCAACCATGCCTTCTCA -> CCCAGGTCAACCATGCCTTCTCAG
CCCGAGTGAAACGGCAGCAGCGAC -> CCGAGTGAAACGGCAGCAGCGACT
TGTACTCTTAAATGGGTGAGTTCA -> GTACTCTTAAATGGGTGAGTTCAT
TGAACCTATATTCAGGCGGTTGTC -> GAACCTATATTCAGGCGGTTGTCT
CTTGGTCCGTTCTACTATACATGA -> TTGGTCCGTTCTACTATACATGAT
ATTGTTTCTTTAGTGTGACCCGGG -> TTGTTTCTTTAGTGTGACCCGGGT
GGCCATGCTTCGGTCGCATACTCA -> GCCATGCTTCGGTCGCATACTCAT
CGCAATCAAGCGGTGGCGAGCGGT -> GCAATCAAGCGGTGGCGAGCGGTA
AATACATACCTTGGCCTTTGTACT -> ATACATACCTTGGCCTTTGTACTC
GGAGCACAGCTATTGTTTCTTTAG -> GAGCACAGCTATTGTTTCTTTAGT
AGCCCTCAGGCTCTATGATTCCCA -> GCCCTCAGGCTCTATGATTCCCAG
GGCACATTTTAACGCATCCCCAAA -> GCACATTTTAACGCATCCCCAAAG
AGGTCATACAAAGAAGGGGAGCAC -> GGTCATACAAAGAAGGGGAGCACA
TGCGGAAAGCTCAAGAATCCCGTC -> GCGGAAAGCTCAAGAATCCCGTCC
AAGCGCACAGTGGCTGCGCGCGTT -> AGCGCACAGTGGCTGCGCGCGTTC
CTATGATTGGTCCTGACGTGCTGA -> TATGATTGGTCCTGACGTGCTGAA
GACGCTCACAGCAGTATGGGTGTA -> ACGCTCACAGCAGTATGGGTGTAT
TCTCTTATGCTCACCAGATTGTTC -> CTCTTATGCTCACCAGATTGTTCC
TGCTGAACCGTTAACGACGGCGGC -> GCTGAACCGTTAACGACGGCGGCG
ACGACGGCGGCGCCCTACCTGGAT -> CGACGGCGGCGCCCTACCTGGATA
ATCGAAAACAAGCAAGGCCGGGTT -> TCGAAAACAAGCAAGGCCGGGTTA
CTTTGAAAGGGCCGCAAGACGGCG -> TTTGAAAGGGCCGCAAGACGGCGC
GAGCGGTAAACAGAACTAAGAGAC -> AGCGGTAAACAGAACTAAGAGACG
CCCGTCGGCAACCATGGGAAACTG -> CCGTCGGCAACCATGGGAAACTGT
TATTATGCTCTCGCTTACTTAACG -> ATTATGCTCTCGCTTACTTAACGT
ATCACAAGAACTCCCTCTTCAATT -> TCACAAGAACTCCCTCTTCAATTT
ATATGCGGAAAGCTCAAGAATCCC -> TATGCGGAAAGCTCAAGAATCCCG
CCCAAAGGCTGAACAGTGGCTCGG -> CCAAAGGCTGAACAGTGGCTCGGA
AACTAGAAGAGGCCCTTCTATCCA -> ACTAGAAGAGGCCCTTCTATCCAG
ACTCACCCTCGCAATTAGGATCTG -> CTCACCCTCGCAATTAGGATCTGG
GAGACGTGCCACATTTCATATATG -> AGACGTGCCACATTTCATATATGC
GCCAGAAAAGCCTAAATCACACTG -> CCAGAAAAGCCTAAATCACACTGG
TCTGCCCGTTTGTACTCTTAAATG -> CTGCCCGTTTGTACTCTTAAATGG
GCTTGCTGAAATATTCCTGGTGAG -> CTTGCTGAAATATTCCTGGTGAGC
TTAACAGTAGACTCTCGAAGGATA -> TAACAGTAGACTCTCGAAGGATAT
CAGGAGTGACTGTCTATGATTGGT -> AGGAGTGACTGTCTATGATTGGTC
CATAGGTTATCACTCCTACCCCCA -> ATAGGTTATCACTCCTACCCCCAT
TACAAAGAAGGGGAGCACAGCTAT -> ACAAAGAAGGGGAGCACAGCTATT
ACCCGGGTGTTACTAGCGCAACTT -> CCCGGGTGTTACTAGCGCAACTTC
CACGAGTGACAGGATTGGTTCAAA -> ACGAGTGACAGGATTGGTTCAAAA
CTGGGGGGATCTTCCTGAATCACC -> TGGGGGGATCTTCCTGAATCACCT
TTCGTCCCATATTCATATGCTTGC -> TCGTCCCATATTCATATGCTTGCT
AACGAGGCGTGTATTCCTCCACCA -> ACGAGGCGTGTATTCCTCCACCAC
TTTGTACTCACCCTCGCAATTAGG -> TTGTACTCACCCTCGCAATTAGGA
GAAACTGTTAACCGTATAATTAGT -> AAACTGTTAACCGTATAATTAGTT
TACGGTTTACAGGGCCTAAGGCTA -> ACGGTTTACAGGGCCTAAGGCTAT
AAATCACACTGGGGGGATCTTCCT -> AATCACACTGGGGGGATCTTCCTG
CCTTAGCTACCTTGGTCCGTTCTA -> CTTAGCTACCTTGGTCCGTTCTAC
TATCGAAAACAAGCAAGGCCGGGT -> ATCGAAAACAAGCAAGGCCGGGTT
CTCAGGCTCTATGATTCCCAGGTC -> TCAGGCTCTATGATTCCCAGGTCA
CTAATTCCGCCAGAAAAGCCTAAA -> TAATTCCGCCAGAAAAGCCTAAAT
CTAAATGTTAACAGTAGACTCTCG -> TAAATGTTAACAGTAGACTCTCGA
TACCCGAGTGAAACGGCAGCAGCG -> ACCCGAGTGAAACGGCAGCAGCGA
CGCTTTATCATCTGGTCCCCAAGC -> GCTTTATCATCTGGTCCCCAAGCC
CAGCAGCGACTCCCTACAGCGGCG -> AGCAGCGACTCCCTACAGCGGCGT
TGTCAAGAAATCAATCGGAAGAAC -> GTCAAGAAATCAATCGGAAGAACG
CCCGCGTCTCTTATGCTCACCAGA -> CCGCGTCTCTTATGCTCACCAGAT
TATACGACTACCTATATTACTGAC -> ATACGACTACCTATATTACTGACA
CTCTATGATTCCCAGGTCAACCAT -> TCTATGATTCCCAGGTCAACCATG
GCGGCGTCGCAAGAATCTCGTTTC -> CGGCGTCGCAAGAATCTCGTTTCC
TCTGGACCGCAATCAAGCGGTGGC -> CTGGACCGCAATCAAGCGGTGGCG
ACATGGTACCGCTTTATCATCTGG -> CATGGTACCGCTTTATCATCTGGT
ATATTCCTGGTGAGCCACGGCCGG -> TATTCCTGGTGAGCCACGGCCGGC
TTCATTGTAGGCGTACCTGTCCCG -> TCATTGTAGGCGTACCTGTCCCGT
AACGTCTGAACCCATAGGTTATCA -> ACGTCTGAACCCATAGGTTATCAC
CCAAAGGCTGAACAGTGGCTCGGA -> CAAAGGCTGAACAGTGGCTCGGAA
TCATATGTACGGAGAAAAACAGGA -> CATATGTACGGAGAAAAACAGGAG
TGGTCTGTACCCGAGTGAAACGGC -> GGTCTGTACCCGAGTGAAACGGCA
GGCTGAACAGTGGCTCGGAATTTG -> GCTGAACAGTGGCTCGGAATTTGA
TGTCCCGTCGGCAACCATGGGAAA -> GTCCCGTCGGCAACCATGGGAAAC
CTTACTTAACGTAACGAATAGTCC -> TTACTTAACGTAACGAATAGTCCG
AGAAAAGCCTAAATCACACTGGGG -> GAAAAGCCTAAATCACACTGGGGG
AGAAAACTAGAAGAGGCCCTTCTA -> GAAAACTAGAAGAGGCCCTTCTAT
TCTTATGCTCACCAGATTGTTCCA -> CTTATGCTCACCAGATTGTTCCAA
GTACTCACCCTCGCAATTAGGATC -> TACTCACCCTCGCAATTAGGATCT
CTAGATGGTTGATACAGTATCCTA -> TAGATGGTTGATACAGTATCCTAT
GGAGAAAAACAGGAGTGACTGTCT -> GAGAAAAACAGGAGTGACTGTCTA
CCTCATTACACACGGGTCGGAGCC -> CTCATTACACACGGGTCGGAGCCA
ACTGTCTATGATTGGTCCTGACGT -> CTGTCTATGATTGGTCCTGACGTG
AATTTTATTACTTGCCTTAGCTAC -> ATTTTATTACTTGCCTTAGCTACC
CAGGCTCTATGATTCCCAGGTCAA -> AGGCTCTATGATTCCCAGGTCAAC
AGGATTGGTTCAAAAATAGAATAC -> GGATTGGTTCAAAAATAGAATACC
GTACCTCATTACACACGGGTCGGA -> TACCTCATTACACACGGGTCGGAG
TCAACCATGCCTTCTCAGGGTCTG -> CAACCATGCCTTCTCAGGGTCTGG
AACGAATAGTCCGGGCGAATACAT -> ACGAATAGTCCGGGCGAATACATA
TGCCCGGCCGCACCACGGACTATA -> GCCCGGCCGCACCACGGACTATAA
CTCACAGCAGTATGGGTGTATCGT -> TCACAGCAGTATGGGTGTATCGTG
CCGTGGTCTGTACCCGAGTGAAAC -> CGTGGTCTGTACCCGAGTGAAACG
AAATCAATCGGAAGAACGGCTGAA -> AATCAATCGGAAGAACGGCTGAAC
TGCTGGACATTTTAATATCAGATG -> GCTGGACATTTTAATATCAGATGG
TGCTTCCCTCTGTCAAGAAATCAA -> GCTTCCCTCTGTCAAGAAATCAAT
CTATACATGATGCATCTTATCGTA -> TATACATGATGCATCTTATCGTAA
TCAGGCTCTATGATTCCCAGGTCA -> CAGGCTCTATGATTCCCAGGTCAA
TCGTGCAGAAAGGGATCTAACCTT -> CGTGCAGAAAGGGATCTAACCTTT
TGGGTGTATCGTGCAGAAAGGGAT -> GGGTGTATCGTGCAGAAAGGGATC
GCCGCAAGACGGCGCTTATGTCCC -> CCGCAAGACGGCGCTTATGTCCCG
GGGATCTTCCTGAATCACCTCACT -> GGATCTTCCTGAATCACCTCACTA
CTTCAATTTTATTACTTGCCTTAG -> TTCAATTTTATTACTTGCCTTAGC
CATTCCGCTTGTAAAAGCATGATC -> ATTCCGCTTGTAAAAGCATGATCT
TATATTACTGACACATGCCAACCT -> ATATTACTGACACATGCCAACCTT
CATTACACACGGGTCGGAGCCAAG -> ATTACACACGGGTCGGAGCCAAGC
TCTGGTCCCCAAGCCCTCAGGCTC -> CTGGTCCCCAAGCCCTCAGGCTCT
GGCTATCGAAAACAAGCAAGGCCG -> GCTATCGAAAACAAGCAAGGCCGG
TGTGTCCCTAATTCCGCCAGAAAA -> GTGTCCCTAATTCCGCCAGAAAAG
CTCGCAATTAGGATCTGGACCGCA -> TCGCAATTAGGATCTGGACCGCAA
ACTGTTAACCGTATAATTAGTTCT -> CTGTTAACCGTATAATTAGTTCTG
TCTGAACCCATAGGTTATCACTCC -> CTGAACCCATAGGTTATCACTCCT
CAGAAAGGGATCTAACCTTTTCGT -> AGAAAGGGATCTAACCTTTTCGTA
AATAGACATGGTACCGCTTTATCA -> ATAGACATGGTACCGCTTTATCAT
ACCGTATAATTAGTTCTGTCTTAT -> CCGTATAATTAGTTCTGTCTTATT
ACTGCCTTTCACATCAAAAATCTT -> CTGCCTTTCACATCAAAAATCTTT
AATCTCGTTTCCCTTTGAAAGGGC -> ATCTCGTTTCCCTTTGAAAGGGCC
GAACTCCCTCTTCAATTTTATTAC -> AACTCCCTCTTCAATTTTATTACT
CCTAAATCACACTGGGGGGATCTT -> CTAAATCACACTGGGGGGATCTTC
TTTCTTTAGTGTGACCCGGGTGTT -> TTCTTTAGTGTGACCCGGGTGTTA
CCGTTAACGACGGCGGCGCCCTAC -> CGTTAACGACGGCGGCGCCCTACC
AATCAAGCGGTGGCGAGCGGTAAA -> ATCAAGCGGTGGCGAGCGGTAAAC
GTCGCAAGAATCTCGTTTCCCTTT -> TCGCAAGAATCTCGTTTCCCTTTG
GCTTATGTCCCGCGTCTCTTATGC -> CTTATGTCCCGCGTCTCTTATGCT
TTGTACTCTTAAATGGGTGAGTTC -> TGTACTCTTAAATGGGTGAGTTCA
TTGTGTCCCTAATTCCGCCAGAAA -> TGTGTCCCTAATTCCGCCAGAAAA
GGTCCCAGAATACTAAATGTTAAC -> GTCCCAGAATACTAAATGTTAACA
TTATTATGCTCTCGCTTACTTAAC -> TATTATGCTCTCGCTTACTTAACG
TCGAACGTCTACGGCCATGCTTCG -> CGAACGTCTACGGCCATGCTTCGG
AGCAGTATGGGTGTATCGTGCAGA -> GCAGTATGGGTGTATCGTGCAGAA
ATATTCATATGCTTGCTGAAATAT -> TATTCATATGCTTGCTGAAATATT
AACCGTTAACGACGGCGGCGCCCT -> ACCGTTAACGACGGCGGCGCCCTA
GACCCGGGTGTTACTAGCGCAACT -> ACCCGGGTGTTACTAGCGCAACTT
GACGTGCCACATTTCATATATGCG -> ACGTGCCACATTTCATATATGCGG
GTCTGAACCCATAGGTTATCACTC -> TCTGAACCCATAGGTTATCACTCC
CGGCTGAACCTATATTCAGGCGGT -> GGCTGAACCTATATTCAGGCGGTT
GATGGTTGATACAGTATCCTATAT -> ATGGTTGATACAGTATCCTATATC
GCAACCATGGGAAACTGTTAACCG -> CAACCATGGGAAACTGTTAACCGT
ACGAATAGTCCGGGCGAATACATA -> CGAATAGTCCGGGCGAATACATAC
TTGCTGAAATATTCCTGGTGAGCC -> TGCTGAAATATTCCTGGTGAGCCA
GTTCTACTATACATGATGCATCTT -> TTCTACTATACATGATGCATCTTA
AGCCAAGCGCACAGTGGCTGCGCG -> GCCAAGCGCACAGTGGCTGCGCGC
TAACGAATAGTCCGGGCGAATACA -> AACGAATAGTCCGGGCGAATACAT
TCATCTGGTCCCCAAGCCCTCAGG -> CATCTGGTCCCCAAGCCCTCAGGC
CTATTAGCCTGAGTGGGACGCTCA -> TATTAGCCTGAGTGGGACGCTCAC
ACTATTAGCCTGAGTGGGACGCTC -> CTATTAGCCTGAGTGGGACGCTCA
GAACTGCCTTTCACATCAAAAATC -> AACTGCCTTTCACATCAAAAATCT
CTTGGCCTTTGTACTCACCCTCGC -> TTGGCCTTTGTACTCACCCTCGCA
GAAAGGGATCTAACCTTTTCGTAC -> AAAGGGATCTAACCTTTTCGTACC
CGGACTATAAGGATAACGAGGCGT -> GGACTATAAGGATAACGAGGCGTG
CCTTTGTACTCACCCTCGCAATTA -> CTTTGTACTCACCCTCGCAATTAG
ACCTATATTACTGACACATGCCAA -> CCTATATTACTGACACATGCCAAC
TTCTTCGTCCCATATTCATATGCT -> TCTTCGTCCCATATTCATATGCTT
TTATCGTAACCGTGGTCTGTACCC -> TATCGTAACCGTGGTCTGTACCCG
ATTACACACGGGTCGGAGCCAAGC -> TTACACACGGGTCGGAGCCAAGCG
TAACCTTTTCGTACCTCATTACAC -> AACCTTTTCGTACCTCATTACACA
GTCTGGAACATGCTGGACATTTTA -> TCTGGAACATGCTGGACATTTTAA
TACGGCCATGCTTCGGTCGCATAC -> ACGGCCATGCTTCGGTCGCATACT
GCCTTTCACATCAAAAATCTTTCT -> CCTTTCACATCAAAAATCTTTCTT
ATATCACGAGTGACAGGATTGGTT -> TATCACGAGTGACAGGATTGGTTC
CTATATCACGAGTGACAGGATTGG -> TATATCACGAGTGACAGGATTGGT
CATTTTAATATCAGATGGTGGCAC -> ATTTTAATATCAGATGGTGGCACA
CTCCTACCCCCATCCAAACCAAGG -> TCCTACCCCCATCCAAACCAAGGT
TCTATGATTCCCAGGTCAACCATG -> CTATGATTCCCAGGTCAACCATGC
TTCGTACCTCATTACACACGGGTC -> TCGTACCTCATTACACACGGGTCG
ACCAGATTGTTCCAATACGTTCTT -> CCAGATTGTTCCAATACGTTCTTC
GTAGGCGTACCTGTCCCGTCGGCA -> TAGGCGTACCTGTCCCGTCGGCAA
AAGCCTAAATCACACTGGGGGGAT -> AGCCTAAATCACACTGGGGGGATC
ACACACGGGTCGGAGCCAAGCGCA -> CACACGGGTCGGAGCCAAGCGCAC
GTTGTGTCCCTAATTCCGCCAGAA -> TTGTGTCCCTAATTCCGCCAGAAA
ACAGAGTGCTTCCCTCTGTCAAGA -> CAGAGTGCTTCCCTCTGTCAAGAA
ATCAAGCGGTGGCGAGCGGTAAAC -> TCAAGCGGTGGCGAGCGGTAAACA
ACGGCCATGCTTCGGTCGCATACT -> CGGCCATGCTTCGGTCGCATACTC
CAGAACTAAGAGACGTGCCACATT -> AGAACTAAGAGACGTGCCACATTT
TGAACTGCCTTTCACATCAAAAAT -> GAACTGCCTTTCACATCAAAAATC
TACCTATATTACTGACACATGCCA -> ACCTATATTACTGACACATGCCAA
TCGAAAACAAGCAAGGCCGGGTTA -> CGAAAACAAGCAAGGCCGGGTTAC
AGAAGAGGCCCTTCTATCCAGTTG -> GAAGAGGCCCTTCTATCCAGTTGT
GGCAACCATGGGAAACTGTTAACC -> GCAACCATGGGAAACTGTTAACCG
GGGTGCCCGGCCGCACCACGGACT -> GGTGCCCGGCCGCACCACGGACTA
AGCAAGGCCGGGTTACCTGGTCCC -> GCAAGGCCGGGTTACCTGGTCCCA
ATACAAAGAAGGGGAGCACAGCTA -> TACAAAGAAGGGGAGCACAGCTAT
ACAGGGCCTAAGGCTATCGAAAAC -> CAGGGCCTAAGGCTATCGAAAACA
CCGGGTTACCTGGTCCCAGAATAC -> CGGGTTACCTGGTCCCAGAATACT
CGCGTCTCTTATGCTCACCAGATT -> GCGTCTCTTATGCTCACCAGATTG
CTGCCCGTTTGTACTCTTAAATGG -> TGCCCGTTTGTACTCTTAAATGGG
AGAGTGCTTCCCTCTGTCAAGAAA -> GAGTGCTTCCCTCTGTCAAGAAAT
ATTTTAACGCATCCCCAAAGGCTG -> TTTTAACGCATCCCCAAAGGCTGA
GAAAACAAGCAAGGCCGGGTTACC -> AAAACAAGCAAGGCCGGGTTACCT
TACTGACACATGCCAACCTTGCTA -> ACTGACACATGCCAACCTTGCTAC
GAGTGCTTCCCTCTGTCAAGAAAT -> AGTGCTTCCCTCTGTCAAGAAATC
CGGCGCTTATGTCCCGCGTCTCTT -> GGCGCTTATGTCCCGCGTCTCTTA
TTTGAAAGGGCCGCAAGACGGCGC -> TTGAAAGGGCCGCAAGACGGCGCT
ATAAGGATAACGAGGCGTGTATTC -> TAAGGATAACGAGGCGTGTATTCC
CATGGGAAACTGTTAACCGTATAA -> ATGGGAAACTGTTAACCGTATAAT
AGCTATTGTTTCTTTAGTGTGACC -> GCTATTGTTTCTTTAGTGTGACCC
CGCAACTTCGAGTAACATCACAAG -> GCAACTTCGAGTAACATCACAAGA
ACAGTAGACTCTCGAAGGATATGC -> CAGTAGACTCTCGAAGGATATGCG
ATCCAGTTGTGTCCCTAATTCCGC -> TCCAGTTGTGTCCCTAATTCCGCC
AACCATGGGAAACTGTTAACCGTA -> ACCATGGGAAACTGTTAACCGTAT
AATTAGTTCTGTCTTATTATGCTC -> ATTAGTTCTGTCTTATTATGCTCT
AAACAAGCAAGGCCGGGTTACCTG -> AACAAGCAAGGCCGGGTTACCTGG
CCTTTGAAAGGGCCGCAAGACGGC -> CTTTGAAAGGGCCGCAAGACGGCG
GTGTGACCCGGGTGTTACTAGCGC -> TGTGACCCGGGTGTTACTAGCGCA
AGCGCACAGTGGCTGCGCGCGTTC -> GCGCACAGTGGCTGCGCGCGTTCG
TACCTGGTCCCAGAATACTAAATG -> ACCTGGTCCCAGAATACTAAATGT
AAGCAAGGCCGGGTTACCTGGTCC -> AGCAAGGCCGGGTTACCTGGTCCC
ACGGAGAAAAACAGGAGTGACTGT -> CGGAGAAAAACAGGAGTGACTGTC
CAAGGCCGGGTTACCTGGTCCCAG -> AAGGCCGGGTTACCTGGTCCCAGA
TGGGACGCTCACAGCAGTATGGGT -> GGGACGCTCACAGCAGTATGGGTG
AGGGTCTGGAACATGCTGGACATT -> GGGTCTGGAACATGCTGGACATTT
TACAGTATCCTATATCACGAGTGA -> ACAGTATCCTATATCACGAGTGAC
TTACCTGGTCCCAGAATACTAAAT -> TACCTGGTCCCAGAATACTAAATG
GCACAGCTATTGTTTCTTTAGTGT -> CACAGCTATTGTTTCTTTAGTGTG
ACATTTCATATATGCGGGTGCCCG -> CATTTCATATATGCGGGTGCCCGG
TGGGAAACTGTTAACCGTATAATT -> GGGAAACTGTTAACCGTATAATTA
CATGCTTCGGTCGCATACTCATAT -> ATGCTTCGGTCGCATACTCATATG
ATGGTACCGCTTTATCATCTGGTC -> TGGTACCGCTTTATCATCTGGTCC
CAGTGGCTGCGCGCGTTCGAACGT -> AGTGGCTGCGCGCGTTCGAACGTC
AGGCTCTATGATTCCCAGGTCAAC -> GGCTCTATGATTCCCAGGTCAACC
GTCCCTAATTCCGCCAGAAAAGCC -> TCCCTAATTCCGCCAGAAAAGCCT
AGTGACAGGATTGGTTCAAAAATA -> GTGACAGGATTGGTTCAAAAATAG
GTAGACTCTCGAAGGATATGCGGA -> TAGACTCTCGAAGGATATGCGGAA
TATGCGGAAAGCTCAAGAATCCCG -> ATGCGGAAAGCTCAAGAATCCCGT
AGCATGATCTCTGCCCGTTTGTAC -> GCATGATCTCTGCCCGTTTGTACT
CCAGTTGTGTCCCTAATTCCGCCA -> CAGTTGTGTCCCTAATTCCGCCAG
GCAGTATGGGTGTATCGTGCAGAA -> CAGTATGGGTGTATCGTGCAGAAA
GGTGGCGAGCGGTAAACAGAACTA -> GTGGCGAGCGGTAAACAGAACTAA
TGTTAACCGTATAATTAGTTCTGT -> GTTAACCGTATAATTAGTTCTGTC
ACTATACATGATGCATCTTATCGT -> CTATACATGATGCATCTTATCGTA
GTATCCTATATCACGAGTGACAGG -> TATCCTATATCACGAGTGACAGGA
GTACCCCGACAGAGTGCTTCCCTC -> TACCCCGACAGAGTGCTTCCCTCT
CATTTTAACGCATCCCCAAAGGCT -> ATTTTAACGCATCCCCAAAGGCTG
TGTTTCTTTAGTGTGACCCGGGTG -> GTTTCTTTAGTGTGACCCGGGTGT
ACGGCCGGCCATCCAATGTATACG -> CGGCCGGCCATCCAATGTATACGA
ATCAATCGGAAGAACGGCTGAACC -> TCAATCGGAAGAACGGCTGAACCT
CTCACCAGATTGTTCCAATACGTT -> TCACCAGATTGTTCCAATACGTTC
GGGTCGGAGCCAAGCGCACAGTGG -> GGTCGGAGCCAAGCGCACAGTGGC
GTCAAGAAATCAATCGGAAGAACG -> TCAAGAAATCAATCGGAAGAACGG
TCATATATGCGGGTGCCCGGCCGC -> CATATATGCGGGTGCCCGGCCGCA
TTCATATGCTTGCTGAAATATTCC -> TCATATGCTTGCTGAAATATTCCT
AAAGGGATCTAACCTTTTCGTACC -> AAGGGATCTAACCTTTTCGTACCT
GTGTTACTAGCGCAACTTCGAGTA -> TGTTACTAGCGCAACTTCGAGTAA
TATCGTGCAGAAAGGGATCTAACC -> ATCGTGCAGAAAGGGATCTAACCT
CAAGCCCTCAGGCTCTATGATTCC -> AAGCCCTCAGGCTCTATGATTCCC
ACCCGAGTGAAACGGCAGCAGCGA -> CCCGAGTGAAACGGCAGCAGCGAC
TATCGTAACCGTGGTCTGTACCCG -> ATCGTAACCGTGGTCTGTACCCGA
GGGAAACTGTTAACCGTATAATTA -> GGAAACTGTTAACCGTATAATTAG
TAAATAGACATGGTACCGCTTTAT -> AAATAGACATGGTACCGCTTTATC
GTGGCTCGGAATTTGAAAACGTCT -> TGGCTCGGAATTTGAAAACGTCTG
TTCTACTATACATGATGCATCTTA -> TCTACTATACATGATGCATCTTAT
GGCGGCGCCCTACCTGGATATTGG -> GCGGCGCCCTACCTGGATATTGGA
GCGCGTTCGAACGTCTACGGCCAT -> CGCGTTCGAACGTCTACGGCCATG
AGGATATGCGGAAAGCTCAAGAAT -> GGATATGCGGAAAGCTCAAGAATC
TCAGGGTCTGGAACATGCTGGACA -> CAGGGTCTGGAACATGCTGGACAT
ATCTTATCGTAACCGTGGTCTGTA -> TCTTATCGTAACCGTGGTCTGTAC
CTTCGAGTAACATCACAAGAACTC -> TTCGAGTAACATCACAAGAACTCC
ATCACACTGGGGGGATCTTCCTGA -> TCACACTGGGGGGATCTTCCTGAA
AACTTCGAGTAACATCACAAGAAC -> ACTTCGAGTAACATCACAAGAACT
GCGCAACTTCGAGTAACATCACAA -> CGCAACTTCGAGTAACATCACAAG
AAGGCTATCGAAAACAAGCAAGGC -> AGGCTATCGAAAACAAGCAAGGCC
GCCGGCCATCCAATGTATACGACT -> CCGGCCATCCAATGTATACGACTA
GCACATTTTAACGCATCCCCAAAG -> CACATTTTAACGCATCCCCAAAGG
GACTGTCTATGATTGGTCCTGACG -> ACTGTCTATGATTGGTCCTGACGT
AATACTAAATGTTAACAGTAGACT -> ATACTAAATGTTAACAGTAGACTC
TGAGTTCATTGTAGGCGTACCTGT -> GAGTTCATTGTAGGCGTACCTGTC
CGGAATTTGAAAACGTCTGAACCC -> GGAATTTGAAAACGTCTGAACCCA
CCTGACGTGCTGAACCGTTAACGA -> CTGACGTGCTGAACCGTTAACGAC
TTTTCGTACCTCATTACACACGGG -> TTTCGTACCTCATTACACACGGGT
CCAAGCCCTCAGGCTCTATGATTC -> CAAGCCCTCAGGCTCTATGATTCC
CGTACCCCGACAGAGTGCTTCCCT -> GTACCCCGACAGAGTGCTTCCCTC
TTTGTACTCTTAAATGGGTGAGTT -> TTGTACTCTTAAATGGGTGAGTTC
TATTAGCCTGAGTGGGACGCTCAC -> ATTAGCCTGAGTGGGACGCTCACA
AAACCAAGGTCATACAAAGAAGGG -> AACCAAGGTCATACAAAGAAGGGG
GCTCTATGATTCCCAGGTCAACCA -> CTCTATGATTCCCAGGTCAACCAT
GGGTGTTACTAGCGCAACTTCGAG -> GGTGTTACTAGCGCAACTTCGAGT
CAGGGCCTAAGGCTATCGAAAACA -> AGGGCCTAAGGCTATCGAAAACAA
ATTCCTGGTGAGCCACGGCCGGCC -> TTCCTGGTGAGCCACGGCCGGCCA
GTGTCCCTAATTCCGCCAGAAAAG -> TGTCCCTAATTCCGCCAGAAAAGC
AAAACAGGAGTGACTGTCTATGAT -> AAACAGGAGTGACTGTCTATGATT
TGAAACGGCAGCAGCGACTCCCTA -> GAAACGGCAGCAGCGACTCCCTAC
GGGCCTAAGGCTATCGAAAACAAG -> GGCCTAAGGCTATCGAAAACAAGC
CCCGGCCGCACCACGGACTATAAG -> CCGGCCGCACCACGGACTATAAGG
TCCGTTCTACTATACATGATGCAT -> CCGTTCTACTATACATGATGCATC
TCTGTCAAGAAATCAATCGGAAGA -> CTGTCAAGAAATCAATCGGAAGAA
GCACAGTGGCTGCGCGCGTTCGAA -> CACAGTGGCTGCGCGCGTTCGAAC
GTCCCGTCGGCAACCATGGGAAAC -> TCCCGTCGGCAACCATGGGAAACT
GAGGTAAAGGACGGACATTGAACT -> AGGTAAAGGACGGACATTGAACTG
TAAAGGACGGACATTGAACTGCCT -> AAAGGACGGACATTGAACTGCCTT
TCGTCCCATATTCATATGCTTGCT -> CGTCCCATATTCATATGCTTGCTG
ATGCCAACCTTGCTACAGCATTCC -> TGCCAACCTTGCTACAGCATTCCG
AGTATGGGTGTATCGTGCAGAAAG -> GTATGGGTGTATCGTGCAGAAAGG
TAAGAGACGTGCCACATTTCATAT -> AAGAGACGTGCCACATTTCATATA
TCGGAAGAACGGCTGAACCTATAT -> CGGAAGAACGGCTGAACCTATATT
ACTAAGAGACGTGCCACATTTCAT -> CTAAGAGACGTGCCACATTTCATA
TTCGAGTAACATCACAAGAACTCC -> TCGAGTAACATCACAAGAACTCCC
GTGACCCGGGTGTTACTAGCGCAA -> TGACCCGGGTGTTACTAGCGCAAC
GTACCGCTTTATCATCTGGTCCCC -> TACCGCTTTATCATCTGGTCCCCA
GAAAAGCCTAAATCACACTGGGGG -> AAAAGCCTAAATCACACTGGGGGG
TTGTCTAGATGGTTGATACAGTAT -> TGTCTAGATGGTTGATACAGTATC
CTCATTACACACGGGTCGGAGCCA -> TCATTACACACGGGTCGGAGCCAA
AATCGGAAGAACGGCTGAACCTAT -> ATCGGAAGAACGGCTGAACCTATA
CGGTAAACAGAACTAAGAGACGTG -> GGTAAACAGAACTAAGAGACGTGC
CAAAAATAGAATACCCCACATACG -> AAAAATAGAATACCCCACATACGG
AATAGTCCGGGCGAATACATACCT -> ATAGTCCGGGCGAATACATACCTT
ATTCATATGCTTGCTGAAATATTC -> TTCATATGCTTGCTGAAATATTCC
CCGGGTGTTACTAGCGCAACTTCG -> CGGGTGTTACTAGCGCAACTTCGA
ATCACCTCACTATTAGCCTGAGTG -> TCACCTCACTATTAGCCTGAGTGG
ATTCCCAGGTCAACCATGCCTTCT -> TTCCCAGGTCAACCATGCCTTCTC
TAGGATCTGGACCGCAATCAAGCG -> AGGATCTGGACCGCAATCAAGCGG
AGATTGTTCCAATACGTTCTTCGT -> GATTGTTCCAATACGTTCTTCGTC
AGGAGTGACTGTCTATGATTGGTC -> GGAGTGACTGTCTATGATTGGTCC
TCTTATCGTAACCGTGGTCTGTAC -> CTTATCGTAACCGTGGTCTGTACC
CAACCATGGGAAACTGTTAACCGT -> AACCATGGGAAACTGTTAACCGTA
ATAATTAGTTCTGTCTTATTATGC -> TAATTAGTTCTGTCTTATTATGCT
CACAAGAACTCCCTCTTCAATTTT -> ACAAGAACTCCCTCTTCAATTTTA
GGCGAGCGGTAAACAGAACTAAGA -> GCGAGCGGTAAACAGAACTAAGAG
TCCAATGTATACGACTACCTATAT -> CCAATGTATACGACTACCTATATT
AGCCACGGCCGGCCATCCAATGTA -> GCCACGGCCGGCCATCCAATGTAT
TCTCTGCCCGTTTGTACTCTTAAA -> CTCTGCCCGTTTGTACTCTTAAAT
ATCTTCCTGAATCACCTCACTATT -> TCTTCCTGAATCACCTCACTATTA
CATGCCTTCTCAGGGTCTGGAACA -> ATGCCTTCTCAGGGTCTGGAACAT
TGGCTCGGAATTTGAAAACGTCTG -> GGCTCGGAATTTGAAAACGTCTGA
CTCCCTCTTCAATTTTATTACTTG -> TCCCTCTTCAATTTTATTACTTGC
CCAACCTTGCTACAGCATTCCGCT -> CAACCTTGCTACAGCATTCCGCTT
TAGTTCTGTCTTATTATGCTCTCG -> AGTTCTGTCTTATTATGCTCTCGC
TCCACCACAGAAAACTAGAAGAGG -> CCACCACAGAAAACTAGAAGAGGC
GGAGCCAAGCGCACAGTGGCTGCG -> GAGCCAAGCGCACAGTGGCTGCGC
AATATCAGATGGTGGCACATTTTA -> ATATCAGATGGTGGCACATTTTAA
CGTTTGTACTCTTAAATGGGTGAG -> GTTTGTACTCTTAAATGGGTGAGT
ACCACGGACTATAAGGATAACGAG -> CCACGGACTATAAGGATAACGAGG
TGTATACGACTACCTATATTACTG -> GTATACGACTACCTATATTACTGA
AGTGCTTCCCTCTGTCAAGAAATC -> GTGCTTCCCTCTGTCAAGAAATCA
TTAACGACGGCGGCGCCCTACCTG -> TAACGACGGCGGCGCCCTACCTGG
GCTACAGCATTCCGCTTGTAAAAG -> CTACAGCATTCCGCTTGTAAAAGC
GTCCCAGAATACTAAATGTTAACA -> TCCCAGAATACTAAATGTTAACAG
AGTAACATCACAAGAACTCCCTCT -> GTAACATCACAAGAACTCCCTCTT
TGCAGAAAGGGATCTAACCTTTTC -> GCAGAAAGGGATCTAACCTTTTCG
GTGTATCGTGCAGAAAGGGATCTA -> TGTATCGTGCAGAAAGGGATCTAA
TTCTATCCAGTTGTGTCCCTAATT -> TCTATCCAGTTGTGTCCCTAATTC
CTTTGTACTCACCCTCGCAATTAG -> TTTGTACTCACCCTCGCAATTAGG
AGTTGTGTCCCTAATTCCGCCAGA -> GTTGTGTCCCTAATTCCGCCAGAA
GGTTACCTGGTCCCAGAATACTAA -> GTTACCTGGTCCCAGAATACTAAA
CGTACCTGTCCCGTCGGCAACCAT -> GTACCTGTCCCGTCGGCAACCATG
ACGACTACCTATATTACTGACACA -> CGACTACCTATATTACTGACACAT
GTACTCTTAAATGGGTGAGTTCAT -> TACTCTTAAATGGGTGAGTTCATT
TTGAAAACGTCTGAACCCATAGGT -> TGAAAACGTCTGAACCCATAGGTT
GAACAGTGGCTCGGAATTTGAAAA -> AACAGTGGCTCGGAATTTGAAAAC
AGATGGTTGATACAGTATCCTATA -> GATGGTTGATACAGTATCCTATAT
CTACCTGGATATTGGACCGTACCC -> TACCTGGATATTGGACCGTACCCC
GCCCGTTTGTACTCTTAAATGGGT -> CCCGTTTGTACTCTTAAATGGGTG
TATCCAGTTGTGTCCCTAATTCCG -> ATCCAGTTGTGTCCCTAATTCCGC
CCCATCCAAACCAAGGTCATACAA -> CCATCCAAACCAAGGTCATACAAA
TTTTATTACTTGCCTTAGCTACCT -> TTTATTACTTGCCTTAGCTACCTT
CCTAAGGCTATCGAAAACAAGCAA -> CTAAGGCTATCGAAAACAAGCAAG
AACGGCAGCAGCGACTCCCTACAG -> ACGGCAGCAGCGACTCCCTACAGC
TGGTGGCACATTTTAACGCATCCC -> GGTGGCACATTTTAACGCATCCCC
TGTCTAGATGGTTGATACAGTATC -> GTCTAGATGGTTGATACAGTATCC
GCATACTCATATGTACGGAGAAAA -> CATACTCATATGTACGGAGAAAAA
TCATATGCTTGCTGAAATATTCCT -> CATATGCTTGCTGAAATATTCCTG
AACGACGGCGGCGCCCTACCTGGA -> ACGACGGCGGCGCCCTACCTGGAT
ATCCTATATCACGAGTGACAGGAT -> TCCTATATCACGAGTGACAGGATT
AAGAATCTCGTTTCCCTTTGAAAG -> AGAATCTCGTTTCCCTTTGAAAGG
CCTCAGGCTCTATGATTCCCAGGT -> CTCAGGCTCTATGATTCCCAGGTC
TACCTTGGCCTTTGTACTCACCCT -> ACCTTGGCCTTTGTACTCACCCTC
AGAAGGGGAGCACAGCTATTGTTT -> GAAGGGGAGCACAGCTATTGTTTC
ACATTTTAACGCATCCCCAAAGGC -> CATTTTAACGCATCCCCAAAGGCT
GTGAAACGGCAGCAGCGACTCCCT -> TGAAACGGCAGCAGCGACTCCCTA
AGACGGCGCTTATGTCCCGCGTCT -> GACGGCGCTTATGTCCCGCGTCTC
ACCTTGGTCCGTTCTACTATACAT -> CCTTGGTCCGTTCTACTATACATG
TACTTGCCTTAGCTACCTTGGTCC -> ACTTGCCTTAGCTACCTTGGTCCG
GTGGCGAGCGGTAAACAGAACTAA -> TGGCGAGCGGTAAACAGAACTAAG
TTTCCCTTTGAAAGGGCCGCAAGA -> TTCCCTTTGAAAGGGCCGCAAGAC
AGGCGTACCTGTCCCGTCGGCAAC -> GGCGTACCTGTCCCGTCGGCAACC
GCGTCGCAAGAATCTCGTTTCCCT -> CGTCGCAAGAATCTCGTTTCCCTT
GACTACCTATATTACTGACACATG -> ACTACCTATATTACTGACACATGC
ACCCCACATACGGTTTACAGGGCC -> CCCCACATACGGTTTACAGGGCCT
CAGCAGTATGGGTGTATCGTGCAG -> AGCAGTATGGGTGTATCGTGCAGA
ACCGTTAACGACGGCGGCGCCCTA -> CCGTTAACGACGGCGGCGCCCTAC
CTCGAAGGATATGCGGAAAGCTCA -> TCGAAGGATATGCGGAAAGCTCAA
CTGTCTATGATTGGTCCTGACGTG -> TGTCTATGATTGGTCCTGACGTGC
GCCTTTGTACTCACCCTCGCAATT -> CCTTTGTACTCACCCTCGCAATTA
TTCATATATGCGGGTGCCCGGCCG -> TCATATATGCGGGTGCCCGGCCGC
ACCTTGGCCTTTGTACTCACCCTC -> CCTTGGCCTTTGTACTCACCCTCG
CGTGCTGAACCGTTAACGACGGCG -> GTGCTGAACCGTTAACGACGGCGG
TGAAAGGGCCGCAAGACGGCGCTT -> GAAAGGGCCGCAAGACGGCGCTTA
CGCTTATGTCCCGCGTCTCTTATG -> GCTTATGTCCCGCGTCTCTTATGC
GAACATGCTGGACATTTTAATATC -> AACATGCTGGACATTTTAATATCA
GTAACGAATAGTCCGGGCGAATAC -> TAACGAATAGTCCGGGCGAATACA
AAGGGCCGCAAGACGGCGCTTATG -> AGGGCCGCAAGACGGCGCTTATGT
AACGTAACGAATAGTCCGGGCGAA -> ACGTAACGAATAGTCCGGGCGAAT
CCTCCACCACAGAAAACTAGAAGA -> CTCCACCACAGAAAACTAGAAGAG
CACATTTTAACGCATCCCCAAAGG -> ACATTTTAACGCATCCCCAAAGGC
TCCCGTCGGCAACCATGGGAAACT -> CCCGTCGGCAACCATGGGAAACTG
GCGTCTCTTATGCTCACCAGATTG -> CGTCTCTTATGCTCACCAGATTGT
TTCAAAAATAGAATACCCCACATA -> TCAAAAATAGAATACCCCACATAC
GGCGTGTATTCCTCCACCACAGAA -> GCGTGTATTCCTCCACCACAGAAA
CATATGCTTGCTGAAATATTCCTG -> ATATGCTTGCTGAAATATTCCTGG
TTATTACTTGCCTTAGCTACCTTG -> TATTACTTGCCTTAGCTACCTTGG
TATTCAGGCGGTTGTCTAGATGGT -> ATTCAGGCGGTTGTCTAGATGGTT
ATCTTTCTTAAATAGACATGGTAC -> TCTTTCTTAAATAGACATGGTACC
CAATTTTATTACTTGCCTTAGCTA -> AATTTTATTACTTGCCTTAGCTAC
GTCTAGATGGTTGATACAGTATCC -> TCTAGATGGTTGATACAGTATCCT
CTCTGTCAAGAAATCAATCGGAAG -> TCTGTCAAGAAATCAATCGGAAGA
TATCACGAGTGACAGGATTGGTTC -> ATCACGAGTGACAGGATTGGTTCA
CTTCCCTCTGTCAAGAAATCAATC -> TTCCCTCTGTCAAGAAATCAATCG
GCTCACCAGATTGTTCCAATACGT -> CTCACCAGATTGTTCCAATACGTT
GATCTTCCTGAATCACCTCACTAT -> ATCTTCCTGAATCACCTCACTATT
CCGCAATCAAGCGGTGGCGAGCGG -> CGCAATCAAGCGGTGGCGAGCGGT
GGTGAGTTCATTGTAGGCGTACCT -> GTGAGTTCATTGTAGGCGTACCTG
GGCCGGCCATCCAATGTATACGAC -> GCCGGCCATCCAATGTATACGACT
CCACATACGGTTTACAGGGCCTAA -> CACATACGGTTTACAGGGCCTAAG
TCAAGAAATCAATCGGAAGAACGG -> CAAGAAATCAATCGGAAGAACGGC
TAGACATGGTACCGCTTTATCATC -> AGACATGGTACCGCTTTATCATCT
CTTCCTGAATCACCTCACTATTAG -> TTCCTGAATCACCTCACTATTAGC
GCAACTTCGAGTAACATCACAAGA -> CAACTTCGAGTAACATCACAAGAA
GCAAGGCCGGGTTACCTGGTCCCA -> CAAGGCCGGGTTACCTGGTCCCAG
GCCCTTCTATCCAGTTGTGTCCCT -> CCCTTCTATCCAGTTGTGTCCCTA
TACGACTACCTATATTACTGACAC -> ACGACTACCTATATTACTGACACA
TAACATCACAAGAACTCCCTCTTC -> AACATCACAAGAACTCCCTCTTCA
TTAGCCTGAGTGGGACGCTCACAG -> TAGCCTGAGTGGGACGCTCACAGC
ACAGTGGCTCGGAATTTGAAAACG -> CAGTGGCTCGGAATTTGAAAACGT
GCACCACGGACTATAAGGATAACG -> CACCACGGACTATAAGGATAACGA
TAACGTAACGAATAGTCCGGGCGA -> AACGTAACGAATAGTCCGGGCGAA
TTCTCAGGGTCTGGAACATGCTGG -> TCTCAGGGTCTGGAACATGCTGGA
ATTTTATTACTTGCCTTAGCTACC -> TTTTATTACTTGCCTTAGCTACCT
TGTCTATGATTGGTCCTGACGTGC -> GTCTATGATTGGTCCTGACGTGCT
CAAGCAAGGCCGGGTTACCTGGTC -> AAGCAAGGCCGGGTTACCTGGTCC
CGGTGGCGAGCGGTAAACAGAACT -> GGTGGCGAGCGGTAAACAGAACTA
CATACCTTGGCCTTTGTACTCACC -> ATACCTTGGCCTTTGTACTCACCC
GACCGCAATCAAGCGGTGGCGAGC -> ACCGCAATCAAGCGGTGGCGAGCG
CGGTCGCATACTCATATGTACGGA -> GGTCGCATACTCATATGTACGGAG
TCCTGGTGAGCCACGGCCGGCCAT -> CCTGGTGAGCCACGGCCGGCCATC
GTCGGAGCCAAGCGCACAGTGGCT -> TCGGAGCCAAGCGCACAGTGGCTG
GACGGCGGCGCCCTACCTGGATAT -> ACGGCGGCGCCCTACCTGGATATT
ATCCCCAAAGGCTGAACAGTGGCT -> TCCCCAAAGGCTGAACAGTGGCTC
GAACTAAGAGACGTGCCACATTTC -> AACTAAGAGACGTGCCACATTTCA
CCGCTTGTAAAAGCATGATCTCTG -> CGCTTGTAAAAGCATGATCTCTGC
ATTATGCTCTCGCTTACTTAACGT -> TTATGCTCTCGCTTACTTAACGTA
CTATCCAGTTGTGTCCCTAATTCC -> TATCCAGTTGTGTCCCTAATTCCG
ACCAAGGTCATACAAAGAAGGGGA -> CCAAGGTCATACAAAGAAGGGGAG
CTCGGAATTTGAAAACGTCTGAAC -> TCGGAATTTGAAAACGTCTGAACC
CTTAACGTAACGAATAGTCCGGGC -> TTAACGTAACGAATAGTCCGGGCG
AAAGGACGGACATTGAACTGCCTT -> AAGGACGGACATTGAACTGCCTTT
CTCTTATGCTCACCAGATTGTTCC -> TCTTATGCTCACCAGATTGTTCCA
AGAAATCAATCGGAAGAACGGCTG -> GAAATCAATCGGAAGAACGGCTGA
GAACCCATAGGTTATCACTCCTAC -> AACCCATAGGTTATCACTCCTACC
ACATACCTTGGCCTTTGTACTCAC -> CATACCTTGGCCTTTGTACTCACC
CAGAATACTAAATGTTAACAGTAG -> AGAATACTAAATGTTAACAGTAGA
TAAGGATAACGAGGCGTGTATTCC -> AAGGATAACGAGGCGTGTATTCCT
AGGATAACGAGGCGTGTATTCCTC -> GGATAACGAGGCGTGTATTCCTCC
GAGCCACGGCCGGCCATCCAATGT -> AGCCACGGCCGGCCATCCAATGTA
GGTCATACAAAGAAGGGGAGCACA -> GTCATACAAAGAAGGGGAGCACAG
ACCCTCGCAATTAGGATCTGGACC -> CCCTCGCAATTAGGATCTGGACCG
ATGTATACGACTACCTATATTACT -> TGTATACGACTACCTATATTACTG
TCCCTCTGTCAAGAAATCAATCGG -> CCCTCTGTCAAGAAATCAATCGGA
GGCGCTTATGTCCCGCGTCTCTTA -> GCGCTTATGTCCCGCGTCTCTTAT
CCTGGTGAGCCACGGCCGGCCATC -> CTGGTGAGCCACGGCCGGCCATCC
GGACCGTACCCCGACAGAGTGCTT -> GACCGTACCCCGACAGAGTGCTTC
ACAGCATTCCGCTTGTAAAAGCAT -> CAGCATTCCGCTTGTAAAAGCATG
GGAGTGACTGTCTATGATTGGTCC -> GAGTGACTGTCTATGATTGGTCCT
TCCAGTTGTGTCCCTAATTCCGCC -> CCAGTTGTGTCCCTAATTCCGCCA
GGGTTACCTGGTCCCAGAATACTA -> GGTTACCTGGTCCCAGAATACTAA
TATCAGATGGTGGCACATTTTAAC -> ATCAGATGGTGGCACATTTTAACG
CTTTCTTAAATAGACATGGTACCG -> TTTCTTAAATAGACATGGTACCGC
CTTTTCGTACCTCATTACACACGG -> TTTTCGTACCTCATTACACACGGG
GAAATCAATCGGAAGAACGGCTGA -> AAATCAATCGGAAGAACGGCTGAA
TGTCCCTAATTCCGCCAGAAAAGC -> GTCCCTAATTCCGCCAGAAAAGCC
TAAAAGCATGATCTCTGCCCGTTT -> AAAAGCATGATCTCTGCCCGTTTG
CTGGAACATGCTGGACATTTTAAT -> TGGAACATGCTGGACATTTTAATA
CGTCGCAAGAATCTCGTTTCCCTT -> GTCGCAAGAATCTCGTTTCCCTTT
TTAGGATCTGGACCGCAATCAAGC -> TAGGATCTGGACCGCAATCAAGCG
AAAGAAGGGGAGCACAGCTATTGT -> AAGAAGGGGAGCACAGCTATTGTT
GTTAACGACGGCGGCGCCCTACCT -> TTAACGACGGCGGCGCCCTACCTG
ATGTCCCGCGTCTCTTATGCTCAC -> TGTCCCGCGTCTCTTATGCTCACC
TGGTCCTGACGTGCTGAACCGTTA -> GGTCCTGACGTGCTGAACCGTTAA
AGTGACTGTCTATGATTGGTCCTG -> GTGACTGTCTATGATTGGTCCTGA
TTTATCATCTGGTCCCCAAGCCCT -> TTATCATCTGGTCCCCAAGCCCTC
ATAGACATGGTACCGCTTTATCAT -> TAGACATGGTACCGCTTTATCATC
TCTTAAATGGGTGAGTTCATTGTA -> CTTAAATGGGTGAGTTCATTGTAG
TGGTCCGTTCTACTATACATGATG -> GGTCCGTTCTACTATACATGATGC
TCTTCGTCCCATATTCATATGCTT -> CTTCGTCCCATATTCATATGCTTG
TCTACTATACATGATGCATCTTAT -> CTACTATACATGATGCATCTTATC
AAATGGGTGAGTTCATTGTAGGCG -> AATGGGTGAGTTCATTGTAGGCGT
CCGGCCGCACCACGGACTATAAGG -> CGGCCGCACCACGGACTATAAGGA
CAAGCGGTGGCGAGCGGTAAACAG -> AAGCGGTGGCGAGCGGTAAACAGA
CTACAGCATTCCGCTTGTAAAAGC -> TACAGCATTCCGCTTGTAAAAGCA
ATACTCATATGTACGGAGAAAAAC -> TACTCATATGTACGGAGAAAAACA
ATTACTGACACATGCCAACCTTGC -> TTACTGACACATGCCAACCTTGCT
ATGATCTCTGCCCGTTTGTACTCT -> TGATCTCTGCCCGTTTGTACTCTT
GGCGTCGCAAGAATCTCGTTTCCC -> GCGTCGCAAGAATCTCGTTTCCCT
TTCCGCTTGTAAAAGCATGATCTC -> TCCGCTTGTAAAAGCATGATCTCT
GGACGCTCACAGCAGTATGGGTGT -> GACGCTCACAGCAGTATGGGTGTA
CCCTACAGCGGCGTCGCAAGAATC -> CCTACAGCGGCGTCGCAAGAATCT
CAACTTCGAGTAACATCACAAGAA -> AACTTCGAGTAACATCACAAGAAC
ATAACGAGGCGTGTATTCCTCCAC -> TAACGAGGCGTGTATTCCTCCACC
CGAGCGGTAAACAGAACTAAGAGA -> GAGCGGTAAACAGAACTAAGAGAC
GAGGCCCTTCTATCCAGTTGTGTC -> AGGCCCTTCTATCCAGTTGTGTCC
AAATAGAATACCCCACATACGGTT -> AATAGAATACCCCACATACGGTTT
AGAGACGTGCCACATTTCATATAT -> GAGACGTGCCACATTTCATATATG
GTTTGTACTCTTAAATGGGTGAGT -> TTTGTACTCTTAAATGGGTGAGTT
ATATTCAGGCGGTTGTCTAGATGG -> TATTCAGGCGGTTGTCTAGATGGT
ACACATGCCAACCTTGCTACAGCA -> CACATGCCAACCTTGCTACAGCAT
CCTACCTGGATATTGGACCGTACC -> CTACCTGGATATTGGACCGTACCC
CACAGTGGCTGCGCGCGTTCGAAC -> ACAGTGGCTGCGCGCGTTCGAACG
TTAGTTCTGTCTTATTATGCTCTC -> TAGTTCTGTCTTATTATGCTCTCG
GTCCCGCGTCTCTTATGCTCACCA -> TCCCGCGTCTCTTATGCTCACCAG
GCGACTCCCTACAGCGGCGTCGCA -> CGACTCCCTACAGCGGCGTCGCAA
TATGCTTGCTGAAATATTCCTGGT -> ATGCTTGCTGAAATATTCCTGGTG
TTCCCTTTGAAAGGGCCGCAAGAC -> TCCCTTTGAAAGGGCCGCAAGACG
TCGGTCGCATACTCATATGTACGG -> CGGTCGCATACTCATATGTACGGA
GTTCCAATACGTTCTTCGTCCCAT -> TTCCAATACGTTCTTCGTCCCATA
TCATACAAAGAAGGGGAGCACAGC -> CATACAAAGAAGGGGAGCACAGCT
GGTGTTACTAGCGCAACTTCGAGT -> GTGTTACTAGCGCAACTTCGAGTA
TGGTGAGCCACGGCCGGCCATCCA -> GGTGAGCCACGGCCGGCCATCCAA
GAAATATTCCTGGTGAGCCACGGC -> AAATATTCCTGGTGAGCCACGGCC
TTATCATCTGGTCCCCAAGCCCTC -> TATCATCTGGTCCCCAAGCCCTCA
TATATGCGGGTGCCCGGCCGCACC -> ATATGCGGGTGCCCGGCCGCACCA
CTGTCAAGAAATCAATCGGAAGAA -> TGTCAAGAAATCAATCGGAAGAAC
GTCTTATTATGCTCTCGCTTACTT -> TCTTATTATGCTCTCGCTTACTTA
TATGATTCCCAGGTCAACCATGCC -> ATGATTCCCAGGTCAACCATGCCT
CGGCCATGCTTCGGTCGCATACTC -> GGCCATGCTTCGGTCGCATACTCA
TTCAGGCGGTTGTCTAGATGGTTG -> TCAGGCGGTTGTCTAGATGGTTGA
TTTAACGCATCCCCAAAGGCTGAA -> TTAACGCATCCCCAAAGGCTGAAC
ACCTCACTATTAGCCTGAGTGGGA -> CCTCACTATTAGCCTGAGTGGGAC
GATCTGGACCGCAATCAAGCGGTG -> ATCTGGACCGCAATCAAGCGGTGG
TAATTCCGCCAGAAAAGCCTAAAT -> AATTCCGCCAGAAAAGCCTAAATC
GGTGAGCCACGGCCGGCCATCCAA -> GTGAGCCACGGCCGGCCATCCAAT
TACCTTGGTCCGTTCTACTATACA -> ACCTTGGTCCGTTCTACTATACAT
TAGTGTGACCCGGGTGTTACTAGC -> AGTGTGACCCGGGTGTTACTAGCG
GAAGAGGCCCTTCTATCCAGTTGT -> AAGAGGCCCTTCTATCCAGTTGTG
ATCTCTGCCCGTTTGTACTCTTAA -> TCTCTGCCCGTTTGTACTCTTAAA
TTATGTCCCGCGTCTCTTATGCTC -> TATGTCCCGCGTCTCTTATGCTCA
GCCAAGCGCACAGTGGCTGCGCGC -> CCAAGCGCACAGTGGCTGCGCGCG
TGGACATTTTAATATCAGATGGTG -> GGACATTTTAATATCAGATGGTGG
TGTAGGCGTACCTGTCCCGTCGGC -> GTAGGCGTACCTGTCCCGTCGGCA
GCGGAAAGCTCAAGAATCCCGTCC -> CGGAAAGCTCAAGAATCCCGTCCT
ATGCTCTCGCTTACTTAACGTAAC -> TGCTCTCGCTTACTTAACGTAACG
AGCGGCGTCGCAAGAATCTCGTTT -> GCGGCGTCGCAAGAATCTCGTTTC
ACTAGCGCAACTTCGAGTAACATC -> CTAGCGCAACTTCGAGTAACATCA
AATACCCCACATACGGTTTACAGG -> ATACCCCACATACGGTTTACAGGG
GACCGTACCCCGACAGAGTGCTTC -> ACCGTACCCCGACAGAGTGCTTCC
GGTCTGTACCCGAGTGAAACGGCA -> GTCTGTACCCGAGTGAAACGGCAG
CATACTCATATGTACGGAGAAAAA -> ATACTCATATGTACGGAGAAAAAC
CTGCGCGCGTTCGAACGTCTACGG -> TGCGCGCGTTCGAACGTCTACGGC
AACGTCTACGGCCATGCTTCGGTC -> ACGTCTACGGCCATGCTTCGGTCG
ATGGGTGAGTTCATTGTAGGCGTA -> TGGGTGAGTTCATTGTAGGCGTAC
GGCAGCAGCGACTCCCTACAGCGG -> GCAGCAGCGACTCCCTACAGCGGC
TCACTATTAGCCTGAGTGGGACGC -> CACTATTAGCCTGAGTGGGACGCT
GTTAACAGTAGACTCTCGAAGGAT -> TTAACAGTAGACTCTCGAAGGATA
ATACGGTTTACAGGGCCTAAGGCT -> TACGGTTTACAGGGCCTAAGGCTA
CGTACCTCATTACACACGGGTCGG -> GTACCTCATTACACACGGGTCGGA
TAGGCGTACCTGTCCCGTCGGCAA -> AGGCGTACCTGTCCCGTCGGCAAC
GCAGCGACTCCCTACAGCGGCGTC -> CAGCGACTCCCTACAGCGGCGTCG
TGGACCGTACCCCGACAGAGTGCT -> GGACCGTACCCCGACAGAGTGCTT
GTATTCCTCCACCACAGAAAACTA -> TATTCCTCCACCACAGAAAACTAG
CCCTCTTCAATTTTATTACTTGCC -> CCTCTTCAATTTTATTACTTGCCT
ATCAGATGGTGGCACATTTTAACG -> TCAGATGGTGGCACATTTTAACGC
ACGAGGCGTGTATTCCTCCACCAC -> CGAGGCGTGTATTCCTCCACCACA
GGATCTTCCTGAATCACCTCACTA -> GATCTTCCTGAATCACCTCACTAT
TAACGACGGCGGCGCCCTACCTGG -> AACGACGGCGGCGCCCTACCTGGA
TGCGGGTGCCCGGCCGCACCACGG -> GCGGGTGCCCGGCCGCACCACGGA
CTCACTATTAGCCTGAGTGGGACG -> TCACTATTAGCCTGAGTGGGACGC
TGACAGGATTGGTTCAAAAATAGA -> GACAGGATTGGTTCAAAAATAGAA
CAGTAGACTCTCGAAGGATATGCG -> AGTAGACTCTCGAAGGATATGCGG
TACTATACATGATGCATCTTATCG -> ACTATACATGATGCATCTTATCGT
GCCACGGCCGGCCATCCAATGTAT -> CCACGGCCGGCCATCCAATGTATA
AACCAAGGTCATACAAAGAAGGGG -> ACCAAGGTCATACAAAGAAGGGGA
ACACTGGGGGGATCTTCCTGAATC -> CACTGGGGGGATCTTCCTGAATCA
TCCCATATTCATATGCTTGCTGAA -> CCCATATTCATATGCTTGCTGAAA
AAGACGGCGCTTATGTCCCGCGTC -> AGACGGCGCTTATGTCCCGCGTCT
AAGGGGAGCACAGCTATTGTTTCT -> AGGGGAGCACAGCTATTGTTTCTT
TTTAATATCAGATGGTGGCACATT -> TTAATATCAGATGGTGGCACATTT
CCATATTCATATGCTTGCTGAAAT -> CATATTCATATGCTTGCTGAAATA
GGGACGCTCACAGCAGTATGGGTG -> GGACGCTCACAGCAGTATGGGTGT
CCTCGCAATTAGGATCTGGACCGC -> CTCGCAATTAGGATCTGGACCGCA
TACATGATGCATCTTATCGTAACC -> ACATGATGCATCTTATCGTAACCG
TAGCCTGAGTGGGACGCTCACAGC -> AGCCTGAGTGGGACGCTCACAGCA
CTATTGTTTCTTTAGTGTGACCCG -> TATTGTTTCTTTAGTGTGACCCGG
TGTGACCCGGGTGTTACTAGCGCA -> GTGACCCGGGTGTTACTAGCGCAA
GCAGAAAGGGATCTAACCTTTTCG -> CAGAAAGGGATCTAACCTTTTCGT
CGCAATTAGGATCTGGACCGCAAT -> GCAATTAGGATCTGGACCGCAATC
ACATTGAACTGCCTTTCACATCAA -> CATTGAACTGCCTTTCACATCAAA
TAGCGCAACTTCGAGTAACATCAC -> AGCGCAACTTCGAGTAACATCACA
CTTCGGTCGCATACTCATATGTAC -> TTCGGTCGCATACTCATATGTACG
GAAAACGTCTGAACCCATAGGTTA -> AAAACGTCTGAACCCATAGGTTAT
CCAAGCGCACAGTGGCTGCGCGCG -> CAAGCGCACAGTGGCTGCGCGCGT
CCCTTTGAAAGGGCCGCAAGACGG -> CCTTTGAAAGGGCCGCAAGACGGC
CATGGTACCGCTTTATCATCTGGT -> ATGGTACCGCTTTATCATCTGGTC
CACACTGGGGGGATCTTCCTGAAT -> ACACTGGGGGGATCTTCCTGAATC
CATCCAATGTATACGACTACCTAT -> ATCCAATGTATACGACTACCTATA
TCTATGATTGGTCCTGACGTGCTG -> CTATGATTGGTCCTGACGTGCTGA
TTGGTTCAAAAATAGAATACCCCA -> TGGTTCAAAAATAGAATACCCCAC
TCGGAGCCAAGCGCACAGTGGCTG -> CGGAGCCAAGCGCACAGTGGCTGC
CAAGGTCATACAAAGAAGGGGAGC -> AAGGTCATACAAAGAAGGGGAGCA
ACATACGGTTTACAGGGCCTAAGG -> CATACGGTTTACAGGGCCTAAGGC
CTACAGCGGCGTCGCAAGAATCTC -> TACAGCGGCGTCGCAAGAATCTCG
GACATTTTAATATCAGATGGTGGC -> ACATTTTAATATCAGATGGTGGCA
ATGCGGAAAGCTCAAGAATCCCGT -> TGCGGAAAGCTCAAGAATCCCGTC
ATCCAAACCAAGGTCATACAAAGA -> TCCAAACCAAGGTCATACAAAGAA
ACTCCTACCCCCATCCAAACCAAG -> CTCCTACCCCCATCCAAACCAAGG
GAAACGGCAGCAGCGACTCCCTAC -> AAACGGCAGCAGCGACTCCCTACA
CGCTCACAGCAGTATGGGTGTATC -> GCTCACAGCAGTATGGGTGTATCG
CCGGGCGAATACATACCTTGGCCT -> CGGGCGAATACATACCTTGGCCTT
CAACCATGCCTTCTCAGGGTCTGG -> AACCATGCCTTCTCAGGGTCTGGA
GTTATCACTCCTACCCCCATCCAA -> TTATCACTCCTACCCCCATCCAAA
CAATCGGAAGAACGGCTGAACCTA -> AATCGGAAGAACGGCTGAACCTAT
ACTCCCTCTTCAATTTTATTACTT -> CTCCCTCTTCAATTTTATTACTTG
TTAAATAGACATGGTACCGCTTTA -> TAAATAGACATGGTACCGCTTTAT
GAATCACCTCACTATTAGCCTGAG -> AATCACCTCACTATTAGCCTGAGT
TCCGCCAGAAAAGCCTAAATCACA -> CCGCCAGAAAAGCCTAAATCACAC
GGAAAGCTCAAGAATCCCGTCCTA -> GAAAGCTCAAGAATCCCGTCCTAG
CCTAATTCCGCCAGAAAAGCCTAA -> CTAATTCCGCCAGAAAAGCCTAAA
AAGGACGGACATTGAACTGCCTTT -> AGGACGGACATTGAACTGCCTTTC
AAAACTAGAAGAGGCCCTTCTATC -> AAACTAGAAGAGGCCCTTCTATCC
CCCATATTCATATGCTTGCTGAAA -> CCATATTCATATGCTTGCTGAAAT
AACCTTGCTACAGCATTCCGCTTG -> ACCTTGCTACAGCATTCCGCTTGT
CATCCAAACCAAGGTCATACAAAG -> ATCCAAACCAAGGTCATACAAAGA
TGAATCACCTCACTATTAGCCTGA -> GAATCACCTCACTATTAGCCTGAG
GAAGAACGGCTGAACCTATATTCA -> AAGAACGGCTGAACCTATATTCAG
ATATGCTTGCTGAAATATTCCTGG -> TATGCTTGCTGAAATATTCCTGGT
GCGGGTGCCCGGCCGCACCACGGA -> CGGGTGCCCGGCCGCACCACGGAC
AGTTCTGTCTTATTATGCTCTCGC -> GTTCTGTCTTATTATGCTCTCGCT
ACGGGTCGGAGCCAAGCGCACAGT -> CGGGTCGGAGCCAAGCGCACAGTG
GACTATAAGGATAACGAGGCGTGT -> ACTATAAGGATAACGAGGCGTGTA
GAAAGGGCCGCAAGACGGCGCTTA -> AAAGGGCCGCAAGACGGCGCTTAT
CAGGGTCTGGAACATGCTGGACAT -> AGGGTCTGGAACATGCTGGACATT
ATTCCTCCACCACAGAAAACTAGA -> TTCCTCCACCACAGAAAACTAGAA
CAAAGAAGGGGAGCACAGCTATTG -> AAAGAAGGGGAGCACAGCTATTGT
AGAACTAAGAGACGTGCCACATTT -> GAACTAAGAGACGTGCCACATTTC
CGAAAACAAGCAAGGCCGGGTTAC -> GAAAACAAGCAAGGCCGGGTTACC
AAGAACGGCTGAACCTATATTCAG -> AGAACGGCTGAACCTATATTCAGG
CCGCGTCTCTTATGCTCACCAGAT -> CGCGTCTCTTATGCTCACCAGATT
CACACGGGTCGGAGCCAAGCGCAC -> ACACGGGTCGGAGCCAAGCGCACA
TCCAAACCAAGGTCATACAAAGAA -> CCAAACCAAGGTCATACAAAGAAG
AAAGCCTAAATCACACTGGGGGGA -> AAGCCTAAATCACACTGGGGGGAT
TTGGCCTTTGTACTCACCCTCGCA -> TGGCCTTTGTACTCACCCTCGCAA
TTGGTCCTGACGTGCTGAACCGTT -> TGGTCCTGACGTGCTGAACCGTTA
CACTATTAGCCTGAGTGGGACGCT -> ACTATTAGCCTGAGTGGGACGCTC
GAATCTCGTTTCCCTTTGAAAGGG -> AATCTCGTTTCCCTTTGAAAGGGC
AGGCGGTTGTCTAGATGGTTGATA -> GGCGGTTGTCTAGATGGTTGATAC
GAACCGTTAACGACGGCGGCGCCC -> AACCGTTAACGACGGCGGCGCCCT
CTACCTATATTACTGACACATGCC -> TACCTATATTACTGACACATGCCA
CCCGGGTGTTACTAGCGCAACTTC -> CCGGGTGTTACTAGCGCAACTTCG
TCCTACCCCCATCCAAACCAAGGT -> CCTACCCCCATCCAAACCAAGGTC
TGATTGGTCCTGACGTGCTGAACC -> GATTGGTCCTGACGTGCTGAACCG
CTTCTCAGGGTCTGGAACATGCTG -> TTCTCAGGGTCTGGAACATGCTGG
AATGGGTGAGTTCATTGTAGGCGT -> ATGGGTGAGTTCATTGTAGGCGTA
AGTCCGGGCGAATACATACCTTGG -> GTCCGGGCGAATACATACCTTGGC
ATGCTTGCTGAAATATTCCTGGTG -> TGCTTGCTGAAATATTCCTGGTGA
CCTATATTCAGGCGGTTGTCTAGA -> CTATATTCAGGCGGTTGTCTAGAT
TTAGCTACCTTGGTCCGTTCTACT -> TAGCTACCTTGGTCCGTTCTACTA
CATTGTAGGCGTACCTGTCCCGTC -> ATTGTAGGCGTACCTGTCCCGTCG
GGGGGGATCTTCCTGAATCACCTC -> GGGGGATCTTCCTGAATCACCTCA
CCACAGAAAACTAGAAGAGGCCCT -> CACAGAAAACTAGAAGAGGCCCTT
TTCGAACGTCTACGGCCATGCTTC -> TCGAACGTCTACGGCCATGCTTCG
CCGCCAGAAAAGCCTAAATCACAC -> CGCCAGAAAAGCCTAAATCACACT
CTTGTAAAAGCATGATCTCTGCCC -> TTGTAAAAGCATGATCTCTGCCCG
GGTTTACAGGGCCTAAGGCTATCG -> GTTTACAGGGCCTAAGGCTATCGA
AGTGAAACGGCAGCAGCGACTCCC -> GTGAAACGGCAGCAGCGACTCCCT
ACGGACATTGAACTGCCTTTCACA -> CGGACATTGAACTGCCTTTCACAT
CCTTTTCGTACCTCATTACACACG -> CTTTTCGTACCTCATTACACACGG
TTACTTGCCTTAGCTACCTTGGTC -> TACTTGCCTTAGCTACCTTGGTCC
TCCCTAATTCCGCCAGAAAAGCCT -> CCCTAATTCCGCCAGAAAAGCCTA
TCACCAGATTGTTCCAATACGTTC -> CACCAGATTGTTCCAATACGTTCT
GCTACCTTGGTCCGTTCTACTATA -> CTACCTTGGTCCGTTCTACTATAC
CTGAACCCATAGGTTATCACTCCT -> TGAACCCATAGGTTATCACTCCTA
CGCGCGTTCGAACGTCTACGGCCA -> GCGCGTTCGAACGTCTACGGCCAT
ACCTTGCTACAGCATTCCGCTTGT -> CCTTGCTACAGCATTCCGCTTGTA
TAAACAGAACTAAGAGACGTGCCA -> AAACAGAACTAAGAGACGTGCCAC
TCTCGCTTACTTAACGTAACGAAT -> CTCGCTTACTTAACGTAACGAATA
TGATGCATCTTATCGTAACCGTGG -> GATGCATCTTATCGTAACCGTGGT
CTAGCGCAACTTCGAGTAACATCA -> TAGCGCAACTTCGAGTAACATCAC
ACAAGAACTCCCTCTTCAATTTTA -> CAAGAACTCCCTCTTCAATTTTAT
GCATCCCCAAAGGCTGAACAGTGG -> CATCCCCAAAGGCTGAACAGTGGC
CTTGCTACAGCATTCCGCTTGTAA -> TTGCTACAGCATTCCGCTTGTAAA
GTACCTGTCCCGTCGGCAACCATG -> TACCTGTCCCGTCGGCAACCATGG
GTCAACCATGCCTTCTCAGGGTCT -> TCAACCATGCCTTCTCAGGGTCTG
GCCCTACCTGGATATTGGACCGTA -> CCCTACCTGGATATTGGACCGTAC
GCATTCCGCTTGTAAAAGCATGAT -> CATTCCGCTTGTAAAAGCATGATC
TGTACCCGAGTGAAACGGCAGCAG -> GTACCCGAGTGAAACGGCAGCAGC
ACCTGGATATTGGACCGTACCCCG -> CCTGGATATTGGACCGTACCCCGA
AAAAGCATGATCTCTGCCCGTTTG -> AAAGCATGATCTCTGCCCGTTTGT
GGAACATGCTGGACATTTTAATAT -> GAACATGCTGGACATTTTAATATC
CCATGCCTTCTCAGGGTCTGGAAC -> CATGCCTTCTCAGGGTCTGGAACA
GTTTACAGGGCCTAAGGCTATCGA -> TTTACAGGGCCTAAGGCTATCGAA
GAAAGCTCAAGAATCCCGTCCTAG -> AAAGCTCAAGAATCCCGTCCTAGG
ATAGAATACCCCACATACGGTTTA -> TAGAATACCCCACATACGGTTTAC
AGTGGCTGCGCGCGTTCGAACGTC -> GTGGCTGCGCGCGTTCGAACGTCT
ATATGTACGGAGAAAAACAGGAGT -> TATGTACGGAGAAAAACAGGAGTG
CTTGCCTTAGCTACCTTGGTCCGT -> TTGCCTTAGCTACCTTGGTCCGTT
CCTCTGTCAAGAAATCAATCGGAA -> CTCTGTCAAGAAATCAATCGGAAG
GTAACATCACAAGAACTCCCTCTT -> TAACATCACAAGAACTCCCTCTTC
GCGTACCTGTCCCGTCGGCAACCA -> CGTACCTGTCCCGTCGGCAACCAT
TGTACGGAGAAAAACAGGAGTGAC -> GTACGGAGAAAAACAGGAGTGACT
TAACGAGGCGTGTATTCCTCCACC -> AACGAGGCGTGTATTCCTCCACCA
TACAGCATTCCGCTTGTAAAAGCA -> ACAGCATTCCGCTTGTAAAAGCAT
GTATGGGTGTATCGTGCAGAAAGG -> TATGGGTGTATCGTGCAGAAAGGG
CAGTATCCTATATCACGAGTGACA -> AGTATCCTATATCACGAGTGACAG
GAATTTGAAAACGTCTGAACCCAT -> AATTTGAAAACGTCTGAACCCATA
TACCCCCATCCAAACCAAGGTCAT -> ACCCCCATCCAAACCAAGGTCATA
GAGTAACATCACAAGAACTCCCTC -> AGTAACATCACAAGAACTCCCTCT
CTATAAGGATAACGAGGCGTGTAT -> TATAAGGATAACGAGGCGTGTATT
ATCGTGCAGAAAGGGATCTAACCT -> TCGTGCAGAAAGGGATCTAACCTT
CTGAATCACCTCACTATTAGCCTG -> TGAATCACCTCACTATTAGCCTGA
GAGAAAAACAGGAGTGACTGTCTA -> AGAAAAACAGGAGTGACTGTCTAT
CGTTAACGACGGCGGCGCCCTACC -> GTTAACGACGGCGGCGCCCTACCT
ATACAGTATCCTATATCACGAGTG -> TACAGTATCCTATATCACGAGTGA
CTACTATACATGATGCATCTTATC -> TACTATACATGATGCATCTTATCG
CCTGGATATTGGACCGTACCCCGA -> CTGGATATTGGACCGTACCCCGAC
TATTACTGACACATGCCAACCTTG -> ATTACTGACACATGCCAACCTTGC
GTGGCTGCGCGCGTTCGAACGTCT -> TGGCTGCGCGCGTTCGAACGTCTA
CGGCGCCCTACCTGGATATTGGAC -> GGCGCCCTACCTGGATATTGGACC
ATTGAACTGCCTTTCACATCAAAA -> TTGAACTGCCTTTCACATCAAAAA
CTAAGAGACGTGCCACATTTCATA -> TAAGAGACGTGCCACATTTCATAT
CGGCGTCGCAAGAATCTCGTTTCC -> GGCGTCGCAAGAATCTCGTTTCCC
ACAGAACTAAGAGACGTGCCACAT -> CAGAACTAAGAGACGTGCCACATT
TCACAGCAGTATGGGTGTATCGTG -> CACAGCAGTATGGGTGTATCGTGC
TTGGACCGTACCCCGACAGAGTGC -> TGGACCGTACCCCGACAGAGTGCT
TATTCCTGGTGAGCCACGGCCGGC -> ATTCCTGGTGAGCCACGGCCGGCC
AAAACAAGCAAGGCCGGGTTACCT -> AAACAAGCAAGGCCGGGTTACCTG
GACATTGAACTGCCTTTCACATCA -> ACATTGAACTGCCTTTCACATCAA
CTGGTCCCCAAGCCCTCAGGCTCT -> TGGTCCCCAAGCCCTCAGGCTCTA
ATACATGATGCATCTTATCGTAAC -> TACATGATGCATCTTATCGTAACC
CAGAAAAGCCTAAATCACACTGGG -> AGAAAAGCCTAAATCACACTGGGG
CAGGTCAACCATGCCTTCTCAGGG -> AGGTCAACCATGCCTTCTCAGGGT
CTTATCGTAACCGTGGTCTGTACC -> TTATCGTAACCGTGGTCTGTACCC
GCTATTGTTTCTTTAGTGTGACCC -> CTATTGTTTCTTTAGTGTGACCCG
CGGGTGCCCGGCCGCACCACGGAC -> GGGTGCCCGGCCGCACCACGGACT
CGCGTTCGAACGTCTACGGCCATG -> GCGTTCGAACGTCTACGGCCATGC
GCAATCAAGCGGTGGCGAGCGGTA -> CAATCAAGCGGTGGCGAGCGGTAA
GATACAGTATCCTATATCACGAGT -> ATACAGTATCCTATATCACGAGTG
CAGGATTGGTTCAAAAATAGAATA -> AGGATTGGTTCAAAAATAGAATAC
ACATGCCAACCTTGCTACAGCATT -> CATGCCAACCTTGCTACAGCATTC
CGGAGCCAAGCGCACAGTGGCTGC -> GGAGCCAAGCGCACAGTGGCTGCG
CGTCGGCAACCATGGGAAACTGTT -> GTCGGCAACCATGGGAAACTGTTA
GAACGGCTGAACCTATATTCAGGC -> AACGGCTGAACCTATATTCAGGCG
AAGCCCTCAGGCTCTATGATTCCC -> AGCCCTCAGGCTCTATGATTCCCA
TCATTGTAGGCGTACCTGTCCCGT -> CATTGTAGGCGTACCTGTCCCGTC
AAAGGGCCGCAAGACGGCGCTTAT -> AAGGGCCGCAAGACGGCGCTTATG
TCCCTACAGCGGCGTCGCAAGAAT -> CCCTACAGCGGCGTCGCAAGAATC
TTGGTCCGTTCTACTATACATGAT -> TGGTCCGTTCTACTATACATGATG
GGATATTGGACCGTACCCCGACAG -> GATATTGGACCGTACCCCGACAGA
AAGGCCGGGTTACCTGGTCCCAGA -> AGGCCGGGTTACCTGGTCCCAGAA
TTCGGTCGCATACTCATATGTACG -> TCGGTCGCATACTCATATGTACGG
TCTACGGCCATGCTTCGGTCGCAT -> CTACGGCCATGCTTCGGTCGCATA
AACGGCTGAACCTATATTCAGGCG -> ACGGCTGAACCTATATTCAGGCGG
AACCTTTTCGTACCTCATTACACA -> ACCTTTTCGTACCTCATTACACAC
CTCTTCAATTTTATTACTTGCCTT -> TCTTCAATTTTATTACTTGCCTTA
GGTAAACAGAACTAAGAGACGTGC -> GTAAACAGAACTAAGAGACGTGCC
ATCATCTGGTCCCCAAGCCCTCAG -> TCATCTGGTCCCCAAGCCCTCAGG
TGAGTGGGACGCTCACAGCAGTAT -> GAGTGGGACGCTCACAGCAGTATG
GTGACAGGATTGGTTCAAAAATAG -> TGACAGGATTGGTTCAAAAATAGA
AAGCTCAAGAATCCCGTCCTAGGT -> AGCTCAAGAATCCCGTCCTAGGTT
CTATGATTCCCAGGTCAACCATGC -> TATGATTCCCAGGTCAACCATGCC
GGTCGCATACTCATATGTACGGAG -> GTCGCATACTCATATGTACGGAGA
ATGCTCACCAGATTGTTCCAATAC -> TGCTCACCAGATTGTTCCAATACG
GTCCTGACGTGCTGAACCGTTAAC -> TCCTGACGTGCTGAACCGTTAACG
GAATACCCCACATACGGTTTACAG -> AATACCCCACATACGGTTTACAGG
GTGCTGAACCGTTAACGACGGCGG -> TGCTGAACCGTTAACGACGGCGGC
CCGTACCCCGACAGAGTGCTTCCC -> CGTACCCCGACAGAGTGCTTCCCT
TCTTATTATGCTCTCGCTTACTTA -> CTTATTATGCTCTCGCTTACTTAA
GTGAGCCACGGCCGGCCATCCAAT -> TGAGCCACGGCCGGCCATCCAATG
TGAACAGTGGCTCGGAATTTGAAA -> GAACAGTGGCTCGGAATTTGAAAA
GTCATACAAAGAAGGGGAGCACAG -> TCATACAAAGAAGGGGAGCACAGC
TGCTCTCGCTTACTTAACGTAACG -> GCTCTCGCTTACTTAACGTAACGA
TACTCTTAAATGGGTGAGTTCATT -> ACTCTTAAATGGGTGAGTTCATTG
TTATCACTCCTACCCCCATCCAAA -> TATCACTCCTACCCCCATCCAAAC
CAGAGTGCTTCCCTCTGTCAAGAA -> AGAGTGCTTCCCTCTGTCAAGAAA
AAGCGGTGGCGAGCGGTAAACAGA -> AGCGGTGGCGAGCGGTAAACAGAA
CCCGACAGAGTGCTTCCCTCTGTC -> CCGACAGAGTGCTTCCCTCTGTCA
ATGTTAACAGTAGACTCTCGAAGG -> TGTTAACAGTAGACTCTCGAAGGA
ACAGTGGCTGCGCGCGTTCGAACG -> CAGTGGCTGCGCGCGTTCGAACGT
AAGCATGATCTCTGCCCGTTTGTA -> AGCATGATCTCTGCCCGTTTGTAC
ACTGGGGGGATCTTCCTGAATCAC -> CTGGGGGGATCTTCCTGAATCACC
TGTTAACAGTAGACTCTCGAAGGA -> GTTAACAGTAGACTCTCGAAGGAT
TAATTAGTTCTGTCTTATTATGCT -> AATTAGTTCTGTCTTATTATGCTC
AGGTCAACCATGCCTTCTCAGGGT -> GGTCAACCATGCCTTCTCAGGGTC
TGGTACCGCTTTATCATCTGGTCC -> GGTACCGCTTTATCATCTGGTCCC
CACTGGGGGGATCTTCCTGAATCA -> ACTGGGGGGATCTTCCTGAATCAC
CTTAAATAGACATGGTACCGCTTT -> TTAAATAGACATGGTACCGCTTTA
GATCTCTGCCCGTTTGTACTCTTA -> ATCTCTGCCCGTTTGTACTCTTAA
AAATCTTTCTTAAATAGACATGGT -> AATCTTTCTTAAATAGACATGGTA
TACACACGGGTCGGAGCCAAGCGC -> ACACACGGGTCGGAGCCAAGCGCA
ATATGCGGGTGCCCGGCCGCACCA -> TATGCGGGTGCCCGGCCGCACCAC
CCAGATTGTTCCAATACGTTCTTC -> CAGATTGTTCCAATACGTTCTTCG
ATTTCATATATGCGGGTGCCCGGC -> TTTCATATATGCGGGTGCCCGGCC
ACTTAACGTAACGAATAGTCCGGG -> CTTAACGTAACGAATAGTCCGGGC
TGACTGTCTATGATTGGTCCTGAC -> GACTGTCTATGATTGGTCCTGACG
ATGTACGGAGAAAAACAGGAGTGA -> TGTACGGAGAAAAACAGGAGTGAC
TAATATCAGATGGTGGCACATTTT -> AATATCAGATGGTGGCACATTTTA
TCATTACACACGGGTCGGAGCCAA -> CATTACACACGGGTCGGAGCCAAG
TGGTCCCCAAGCCCTCAGGCTCTA -> GGTCCCCAAGCCCTCAGGCTCTAT
GGCCGCAAGACGGCGCTTATGTCC -> GCCGCAAGACGGCGCTTATGTCCC
CGACTACCTATATTACTGACACAT -> GACTACCTATATTACTGACACATG
CGGTTTACAGGGCCTAAGGCTATC -> GGTTTACAGGGCCTAAGGCTATCG
ATTGTAGGCGTACCTGTCCCGTCG -> TTGTAGGCGTACCTGTCCCGTCGG
GGCTCTATGATTCCCAGGTCAACC -> GCTCTATGATTCCCAGGTCAACCA
CCCTTCTATCCAGTTGTGTCCCTA -> CCTTCTATCCAGTTGTGTCCCTAA
CTCGCTTACTTAACGTAACGAATA -> TCGCTTACTTAACGTAACGAATAG
AGGGCCGCAAGACGGCGCTTATGT -> GGGCCGCAAGACGGCGCTTATGTC
CCCCAAAGGCTGAACAGTGGCTCG -> CCCAAAGGCTGAACAGTGGCTCGG
TTTCACATCAAAAATCTTTCTTAA -> TTCACATCAAAAATCTTTCTTAAA
GTTAACCGTATAATTAGTTCTGTC -> TTAACCGTATAATTAGTTCTGTCT
TGCCTTTCACATCAAAAATCTTTC -> GCCTTTCACATCAAAAATCTTTCT
GTTCAAAAATAGAATACCCCACAT -> TTCAAAAATAGAATACCCCACATA
TCAAAAATCTTTCTTAAATAGACA -> CAAAAATCTTTCTTAAATAGACAT
CAATGTATACGACTACCTATATTA -> AATGTATACGACTACCTATATTAC
CTGGACCGCAATCAAGCGGTGGCG -> TGGACCGCAATCAAGCGGTGGCGA
TCTTTCTTAAATAGACATGGTACC -> CTTTCTTAAATAGACATGGTACCG
TGGTTGATACAGTATCCTATATCA -> GGTTGATACAGTATCCTATATCAC
ATGATTCCCAGGTCAACCATGCCT -> TGATTCCCAGGTCAACCATGCCTT
AAAGCATGATCTCTGCCCGTTTGT -> AAGCATGATCTCTGCCCGTTTGTA
CTGTTAACCGTATAATTAGTTCTG -> TGTTAACCGTATAATTAGTTCTGT
CTCACCCTCGCAATTAGGATCTGG -> TCACCCTCGCAATTAGGATCTGGA
CCTTCTATCCAGTTGTGTCCCTAA -> CTTCTATCCAGTTGTGTCCCTAAT
ACCCCCATCCAAACCAAGGTCATA -> CCCCCATCCAAACCAAGGTCATAC
AGGCTATCGAAAACAAGCAAGGCC -> GGCTATCGAAAACAAGCAAGGCCG
TGAACCGTTAACGACGGCGGCGCC -> GAACCGTTAACGACGGCGGCGCCC
TCTAGATGGTTGATACAGTATCCT -> CTAGATGGTTGATACAGTATCCTA
CAGCGGCGTCGCAAGAATCTCGTT -> AGCGGCGTCGCAAGAATCTCGTTT
AATTTGAAAACGTCTGAACCCATA -> ATTTGAAAACGTCTGAACCCATAG
TCTCGTTTCCCTTTGAAAGGGCCG -> CTCGTTTCCCTTTGAAAGGGCCGC
GTCGCATACTCATATGTACGGAGA -> TCGCATACTCATATGTACGGAGAA
GAATACATACCTTGGCCTTTGTAC -> AATACATACCTTGGCCTTTGTACT
TTAGTGTGACCCGGGTGTTACTAG -> TAGTGTGACCCGGGTGTTACTAGC
AACAAGCAAGGCCGGGTTACCTGG -> ACAAGCAAGGCCGGGTTACCTGGT
TCTATCCAGTTGTGTCCCTAATTC -> CTATCCAGTTGTGTCCCTAATTCC
CGAATACATACCTTGGCCTTTGTA -> GAATACATACCTTGGCCTTTGTAC
ACCGTGGTCTGTACCCGAGTGAAA -> CCGTGGTCTGTACCCGAGTGAAAC
CGCCAGAAAAGCCTAAATCACACT -> GCCAGAAAAGCCTAAATCACACTG
CAGGCGGTTGTCTAGATGGTTGAT -> AGGCGGTTGTCTAGATGGTTGATA
CTCTTAAATGGGTGAGTTCATTGT -> TCTTAAATGGGTGAGTTCATTGTA
CATGATCTCTGCCCGTTTGTACTC -> ATGATCTCTGCCCGTTTGTACTCT
GCGCACAGTGGCTGCGCGCGTTCG -> CGCACAGTGGCTGCGCGCGTTCGA
AAAGGCTGAACAGTGGCTCGGAAT -> AAGGCTGAACAGTGGCTCGGAATT
GTGCCCGGCCGCACCACGGACTAT -> TGCCCGGCCGCACCACGGACTATA
GCTTGTAAAAGCATGATCTCTGCC -> CTTGTAAAAGCATGATCTCTGCCC
CGCATCCCCAAAGGCTGAACAGTG -> GCATCCCCAAAGGCTGAACAGTGG
ATATCAGATGGTGGCACATTTTAA -> TATCAGATGGTGGCACATTTTAAC
TATTGGACCGTACCCCGACAGAGT -> ATTGGACCGTACCCCGACAGAGTG
ACCGCTTTATCATCTGGTCCCCAA -> CCGCTTTATCATCTGGTCCCCAAG
ACAAGCAAGGCCGGGTTACCTGGT -> CAAGCAAGGCCGGGTTACCTGGTC
TCACTCCTACCCCCATCCAAACCA -> CACTCCTACCCCCATCCAAACCAA
AAACAGAACTAAGAGACGTGCCAC -> AACAGAACTAAGAGACGTGCCACA
GAAAAACAGGAGTGACTGTCTATG -> AAAAACAGGAGTGACTGTCTATGA
AACAGGAGTGACTGTCTATGATTG -> ACAGGAGTGACTGTCTATGATTGG
AAACTGTTAACCGTATAATTAGTT -> AACTGTTAACCGTATAATTAGTTC
CTGTCCCGTCGGCAACCATGGGAA -> TGTCCCGTCGGCAACCATGGGAAA
TACCTGTCCCGTCGGCAACCATGG -> ACCTGTCCCGTCGGCAACCATGGG
GCCATCCAATGTATACGACTACCT -> CCATCCAATGTATACGACTACCTA
CTTAGCTACCTTGGTCCGTTCTAC -> TTAGCTACCTTGGTCCGTTCTACT
CCATGGGAAACTGTTAACCGTATA -> CATGGGAAACTGTTAACCGTATAA
ACTCCCTACAGCGGCGTCGCAAGA -> CTCCCTACAGCGGCGTCGCAAGAA
TAACCGTGGTCTGTACCCGAGTGA -> AACCGTGGTCTGTACCCGAGTGAA
ATTGGTTCAAAAATAGAATACCCC -> TTGGTTCAAAAATAGAATACCCCA
GCCCGGCCGCACCACGGACTATAA -> CCCGGCCGCACCACGGACTATAAG
GTTTCTTTAGTGTGACCCGGGTGT -> TTTCTTTAGTGTGACCCGGGTGTT
GCCAACCTTGCTACAGCATTCCGC -> CCAACCTTGCTACAGCATTCCGCT
CCGGCCATCCAATGTATACGACTA -> CGGCCATCCAATGTATACGACTAC
ACGGCTGAACCTATATTCAGGCGG -> CGGCTGAACCTATATTCAGGCGGT
AGAGGCCCTTCTATCCAGTTGTGT -> GAGGCCCTTCTATCCAGTTGTGTC
CCAGGTCAACCATGCCTTCTCAGG -> CAGGTCAACCATGCCTTCTCAGGG
TGCCTTAGCTACCTTGGTCCGTTC -> GCCTTAGCTACCTTGGTCCGTTCT
GGACCGCAATCAAGCGGTGGCGAG -> GACCGCAATCAAGCGGTGGCGAGC
GCTTCGGTCGCATACTCATATGTA -> CTTCGGTCGCATACTCATATGTAC
CTTGCTGAAATATTCCTGGTGAGC -> TTGCTGAAATATTCCTGGTGAGCC
AACTAAGAGACGTGCCACATTTCA -> ACTAAGAGACGTGCCACATTTCAT
GATTCCCAGGTCAACCATGCCTTC -> ATTCCCAGGTCAACCATGCCTTCT
CGTGCAGAAAGGGATCTAACCTTT -> GTGCAGAAAGGGATCTAACCTTTT
CTATATTCAGGCGGTTGTCTAGAT -> TATATTCAGGCGGTTGTCTAGATG
TTATGCTCACCAGATTGTTCCAAT -> TATGCTCACCAGATTGTTCCAATA
TTGTACTCACCCTCGCAATTAGGA -> TGTACTCACCCTCGCAATTAGGAT
CACATTTCATATATGCGGGTGCCC -> ACATTTCATATATGCGGGTGCCCG
AATAGAATACCCCACATACGGTTT -> ATAGAATACCCCACATACGGTTTA
GCCACATTTCATATATGCGGGTGC -> CCACATTTCATATATGCGGGTGCC
CAAGAACTCCCTCTTCAATTTTAT -> AAGAACTCCCTCTTCAATTTTATT
ATGCATCTTATCGTAACCGTGGTC -> TGCATCTTATCGTAACCGTGGTCT
ATCGTAACCGTGGTCTGTACCCGA -> TCGTAACCGTGGTCTGTACCCGAG
CACGGGTCGGAGCCAAGCGCACAG -> ACGGGTCGGAGCCAAGCGCACAGT
CTTTAGTGTGACCCGGGTGTTACT -> TTTAGTGTGACCCGGGTGTTACTA
GCGAGCGGTAAACAGAACTAAGAG -> CGAGCGGTAAACAGAACTAAGAGA
TTCTTAAATAGACATGGTACCGCT -> TCTTAAATAGACATGGTACCGCTT
ATCTGGACCGCAATCAAGCGGTGG -> TCTGGACCGCAATCAAGCGGTGGC
AGGGCCTAAGGCTATCGAAAACAA -> GGGCCTAAGGCTATCGAAAACAAG
CAAAGGCTGAACAGTGGCTCGGAA -> AAAGGCTGAACAGTGGCTCGGAAT
AGCCTAAATCACACTGGGGGGATC -> GCCTAAATCACACTGGGGGGATCT
TCTTAAATAGACATGGTACCGCTT -> CTTAAATAGACATGGTACCGCTTT
CCAGAAAAGCCTAAATCACACTGG -> CAGAAAAGCCTAAATCACACTGGG
CCTACAGCGGCGTCGCAAGAATCT -> CTACAGCGGCGTCGCAAGAATCTC
GTTACTAGCGCAACTTCGAGTAAC -> TTACTAGCGCAACTTCGAGTAACA
ACCATGGGAAACTGTTAACCGTAT -> CCATGGGAAACTGTTAACCGTATA
CAAGCGCACAGTGGCTGCGCGCGT -> AAGCGCACAGTGGCTGCGCGCGTT
CCCAGGTCAACCATGCCTTCTCAG -> CCAGGTCAACCATGCCTTCTCAGG
CCTTGGCCTTTGTACTCACCCTCG -> CTTGGCCTTTGTACTCACCCTCGC
CCTGGTCCCAGAATACTAAATGTT -> CTGGTCCCAGAATACTAAATGTTA
ATTAGCCTGAGTGGGACGCTCACA -> TTAGCCTGAGTGGGACGCTCACAG
CTCGTTTCCCTTTGAAAGGGCCGC -> TCGTTTCCCTTTGAAAGGGCCGCA
TTACAGGGCCTAAGGCTATCGAAA -> TACAGGGCCTAAGGCTATCGAAAA
CCTCACTATTAGCCTGAGTGGGAC -> CTCACTATTAGCCTGAGTGGGACG
CAGATGGTGGCACATTTTAACGCA -> AGATGGTGGCACATTTTAACGCAT
AAATATTCCTGGTGAGCCACGGCC -> AATATTCCTGGTGAGCCACGGCCG
ATATTGGACCGTACCCCGACAGAG -> TATTGGACCGTACCCCGACAGAGT
TGGGTGAGTTCATTGTAGGCGTAC -> GGGTGAGTTCATTGTAGGCGTACC
AGCGGTAAACAGAACTAAGAGACG -> GCGGTAAACAGAACTAAGAGACGT
TGTCTTATTATGCTCTCGCTTACT -> GTCTTATTATGCTCTCGCTTACTT
CTTAAATGGGTGAGTTCATTGTAG -> TTAAATGGGTGAGTTCATTGTAGG
GCGTTCGAACGTCTACGGCCATGC -> CGTTCGAACGTCTACGGCCATGCT
CAGCTATTGTTTCTTTAGTGTGAC -> AGCTATTGTTTCTTTAGTGTGACC
GGGTGTATCGTGCAGAAAGGGATC -> GGTGTATCGTGCAGAAAGGGATCT
AACTGTTAACCGTATAATTAGTTC -> ACTGTTAACCGTATAATTAGTTCT
CTCTGCCCGTTTGTACTCTTAAAT -> TCTGCCCGTTTGTACTCTTAAATG
TTCCCTCTGTCAAGAAATCAATCG -> TCCCTCTGTCAAGAAATCAATCGG
TTACTTAACGTAACGAATAGTCCG -> TACTTAACGTAACGAATAGTCCGG
CCTGTCCCGTCGGCAACCATGGGA -> CTGTCCCGTCGGCAACCATGGGAA
TCGGAATTTGAAAACGTCTGAACC -> CGGAATTTGAAAACGTCTGAACCC
TATATTCAGGCGGTTGTCTAGATG -> ATATTCAGGCGGTTGTCTAGATGG
GCAAGACGGCGCTTATGTCCCGCG -> CAAGACGGCGCTTATGTCCCGCGT
GAATACTAAATGTTAACAGTAGAC -> AATACTAAATGTTAACAGTAGACT
TGCCCGTTTGTACTCTTAAATGGG -> GCCCGTTTGTACTCTTAAATGGGT
ATTTGAAAACGTCTGAACCCATAG -> TTTGAAAACGTCTGAACCCATAGG
TACCTGGATATTGGACCGTACCCC -> ACCTGGATATTGGACCGTACCCCG
GGCCATCCAATGTATACGACTACC -> GCCATCCAATGTATACGACTACCT
CTGACGTGCTGAACCGTTAACGAC -> TGACGTGCTGAACCGTTAACGACG
CCCTCGCAATTAGGATCTGGACCG -> CCTCGCAATTAGGATCTGGACCGC
AGCACAGCTATTGTTTCTTTAGTG -> GCACAGCTATTGTTTCTTTAGTGT
CGAACGTCTACGGCCATGCTTCGG -> GAACGTCTACGGCCATGCTTCGGT
ACAGAAAACTAGAAGAGGCCCTTC -> CAGAAAACTAGAAGAGGCCCTTCT
TTCCAATACGTTCTTCGTCCCATA -> TCCAATACGTTCTTCGTCCCATAT
CTAACCTTTTCGTACCTCATTACA -> TAACCTTTTCGTACCTCATTACAC
ATCAAAAATCTTTCTTAAATAGAC -> TCAAAAATCTTTCTTAAATAGACA
TAGGTTATCACTCCTACCCCCATC -> AGGTTATCACTCCTACCCCCATCC
TCACAAGAACTCCCTCTTCAATTT -> CACAAGAACTCCCTCTTCAATTTT
ACATGCTGGACATTTTAATATCAG -> CATGCTGGACATTTTAATATCAGA
TTAAATGGGTGAGTTCATTGTAGG -> TAAATGGGTGAGTTCATTGTAGGC
TAACGCATCCCCAAAGGCTGAACA -> AACGCATCCCCAAAGGCTGAACAG
ACCTGGTCCCAGAATACTAAATGT -> CCTGGTCCCAGAATACTAAATGTT
TTGTTCCAATACGTTCTTCGTCCC -> TGTTCCAATACGTTCTTCGTCCCA
CGAGTGAAACGGCAGCAGCGACTC -> GAGTGAAACGGCAGCAGCGACTCC
ACTTGCCTTAGCTACCTTGGTCCG -> CTTGCCTTAGCTACCTTGGTCCGT
AAGAAGGGGAGCACAGCTATTGTT -> AGAAGGGGAGCACAGCTATTGTTT
TTCTGTCTTATTATGCTCTCGCTT -> TCTGTCTTATTATGCTCTCGCTTA
GTGGGACGCTCACAGCAGTATGGG -> TGGGACGCTCACAGCAGTATGGGT
AATCAATCGGAAGAACGGCTGAAC -> ATCAATCGGAAGAACGGCTGAACC
ACTATAAGGATAACGAGGCGTGTA -> CTATAAGGATAACGAGGCGTGTAT
GGATATGCGGAAAGCTCAAGAATC -> GATATGCGGAAAGCTCAAGAATCC
GGACATTGAACTGCCTTTCACATC -> GACATTGAACTGCCTTTCACATCA
GCCTAAGGCTATCGAAAACAAGCA -> CCTAAGGCTATCGAAAACAAGCAA
GATGGTGGCACATTTTAACGCATC -> ATGGTGGCACATTTTAACGCATCC
CAGTGGCTCGGAATTTGAAAACGT -> AGTGGCTCGGAATTTGAAAACGTC
ATGCTGGACATTTTAATATCAGAT -> TGCTGGACATTTTAATATCAGATG
AACAGAACTAAGAGACGTGCCACA -> ACAGAACTAAGAGACGTGCCACAT
GGGGAGCACAGCTATTGTTTCTTT -> GGGAGCACAGCTATTGTTTCTTTA
CGGCCGGCCATCCAATGTATACGA -> GGCCGGCCATCCAATGTATACGAC
GGCTGCGCGCGTTCGAACGTCTAC -> GCTGCGCGCGTTCGAACGTCTACG
CGCACAGTGGCTGCGCGCGTTCGA -> GCACAGTGGCTGCGCGCGTTCGAA
TCAGGCGGTTGTCTAGATGGTTGA -> CAGGCGGTTGTCTAGATGGTTGAT
TCAATTTTATTACTTGCCTTAGCT -> CAATTTTATTACTTGCCTTAGCTA
TCGCAATTAGGATCTGGACCGCAA -> CGCAATTAGGATCTGGACCGCAAT
TATCATCTGGTCCCCAAGCCCTCA -> ATCATCTGGTCCCCAAGCCCTCAG
CCGCACCACGGACTATAAGGATAA -> CGCACCACGGACTATAAGGATAAC
CACCAGATTGTTCCAATACGTTCT -> ACCAGATTGTTCCAATACGTTCTT
GAGTGGGACGCTCACAGCAGTATG -> AGTGGGACGCTCACAGCAGTATGG
TACTAAATGTTAACAGTAGACTCT -> ACTAAATGTTAACAGTAGACTCTC
CTGAAATATTCCTGGTGAGCCACG -> TGAAATATTCCTGGTGAGCCACGG
GCTGCGCGCGTTCGAACGTCTACG -> CTGCGCGCGTTCGAACGTCTACGG
TGCTGAAATATTCCTGGTGAGCCA -> GCTGAAATATTCCTGGTGAGCCAC
CATCACAAGAACTCCCTCTTCAAT -> ATCACAAGAACTCCCTCTTCAATT
CGTCTCTTATGCTCACCAGATTGT -> GTCTCTTATGCTCACCAGATTGTT
TCCAATACGTTCTTCGTCCCATAT -> CCAATACGTTCTTCGTCCCATATT
AACGCATCCCCAAAGGCTGAACAG -> ACGCATCCCCAAAGGCTGAACAGT
AGCTACCTTGGTCCGTTCTACTAT -> GCTACCTTGGTCCGTTCTACTATA
TTCCCAGGTCAACCATGCCTTCTC -> TCCCAGGTCAACCATGCCTTCTCA
TCGCAAGAATCTCGTTTCCCTTTG -> CGCAAGAATCTCGTTTCCCTTTGA
GTTTCCCTTTGAAAGGGCCGCAAG -> TTTCCCTTTGAAAGGGCCGCAAGA
TAGATGGTTGATACAGTATCCTAT -> AGATGGTTGATACAGTATCCTATA
CTTATGTCCCGCGTCTCTTATGCT -> TTATGTCCCGCGTCTCTTATGCTC
GCTATCGAAAACAAGCAAGGCCGG -> CTATCGAAAACAAGCAAGGCCGGG
TGCTTGCTGAAATATTCCTGGTGA -> GCTTGCTGAAATATTCCTGGTGAG
AAATAGACATGGTACCGCTTTATC -> AATAGACATGGTACCGCTTTATCA
AACCTATATTCAGGCGGTTGTCTA -> ACCTATATTCAGGCGGTTGTCTAG
AAAATCTTTCTTAAATAGACATGG -> AAATCTTTCTTAAATAGACATGGT
CGCATACTCATATGTACGGAGAAA -> GCATACTCATATGTACGGAGAAAA
AGAACTCCCTCTTCAATTTTATTA -> GAACTCCCTCTTCAATTTTATTAC
TATATCACGAGTGACAGGATTGGT -> ATATCACGAGTGACAGGATTGGTT
GTGACTGTCTATGATTGGTCCTGA -> TGACTGTCTATGATTGGTCCTGAC
TCCGGGCGAATACATACCTTGGCC -> CCGGGCGAATACATACCTTGGCCT
ACATTTTAATATCAGATGGTGGCA -> CATTTTAATATCAGATGGTGGCAC
AGTTCATTGTAGGCGTACCTGTCC -> GTTCATTGTAGGCGTACCTGTCCC
CAATCAAGCGGTGGCGAGCGGTAA -> AATCAAGCGGTGGCGAGCGGTAAA
TGCCACATTTCATATATGCGGGTG -> GCCACATTTCATATATGCGGGTGC
CTGGTCCCAGAATACTAAATGTTA -> TGGTCCCAGAATACTAAATGTTAA
AGGTTATCACTCCTACCCCCATCC -> GGTTATCACTCCTACCCCCATCCA
TAAATGGGTGAGTTCATTGTAGGC -> AAATGGGTGAGTTCATTGTAGGCG
AAACGTCTGAACCCATAGGTTATC -> AACGTCTGAACCCATAGGTTATCA
CCGCAAGACGGCGCTTATGTCCCG -> CGCAAGACGGCGCTTATGTCCCGC
TGCGCGCGTTCGAACGTCTACGGC -> GCGCGCGTTCGAACGTCTACGGCC
ACAGGAGTGACTGTCTATGATTGG -> CAGGAGTGACTGTCTATGATTGGT
AACAGTGGCTCGGAATTTGAAAAC -> ACAGTGGCTCGGAATTTGAAAACG
CATGCTGGACATTTTAATATCAGA -> ATGCTGGACATTTTAATATCAGAT
CGCCCTACCTGGATATTGGACCGT -> GCCCTACCTGGATATTGGACCGTA
TATTGTTTCTTTAGTGTGACCCGG -> ATTGTTTCTTTAGTGTGACCCGGG
CAGATTGTTCCAATACGTTCTTCG -> AGATTGTTCCAATACGTTCTTCGT
TATAAGGATAACGAGGCGTGTATT -> ATAAGGATAACGAGGCGTGTATTC
AGGTAAAGGACGGACATTGAACTG -> GGTAAAGGACGGACATTGAACTGC
TGAACCCATAGGTTATCACTCCTA -> GAACCCATAGGTTATCACTCCTAC
AACAGTAGACTCTCGAAGGATATG -> ACAGTAGACTCTCGAAGGATATGC
TCGTACCTCATTACACACGGGTCG -> CGTACCTCATTACACACGGGTCGG
TCAGATGGTGGCACATTTTAACGC -> CAGATGGTGGCACATTTTAACGCA
TGATCTCTGCCCGTTTGTACTCTT -> GATCTCTGCCCGTTTGTACTCTTA
AATCACACTGGGGGGATCTTCCTG -> ATCACACTGGGGGGATCTTCCTGA
CAACCTTGCTACAGCATTCCGCTT -> AACCTTGCTACAGCATTCCGCTTG
CGTGCCACATTTCATATATGCGGG -> GTGCCACATTTCATATATGCGGGT
ATGGGAAACTGTTAACCGTATAAT -> TGGGAAACTGTTAACCGTATAATT
CGTTTCCCTTTGAAAGGGCCGCAA -> GTTTCCCTTTGAAAGGGCCGCAAG
TGCTTCGGTCGCATACTCATATGT -> GCTTCGGTCGCATACTCATATGTA
AGACTCTCGAAGGATATGCGGAAA -> GACTCTCGAAGGATATGCGGAAAG
CAATACGTTCTTCGTCCCATATTC -> AATACGTTCTTCGTCCCATATTCA
CCATCCAAACCAAGGTCATACAAA -> CATCCAAACCAAGGTCATACAAAG
GACATGGTACCGCTTTATCATCTG -> ACATGGTACCGCTTTATCATCTGG
CGAGTGACAGGATTGGTTCAAAAA -> GAGTGACAGGATTGGTTCAAAAAT
GACGGACATTGAACTGCCTTTCAC -> ACGGACATTGAACTGCCTTTCACA
GCCGCACCACGGACTATAAGGATA -> CCGCACCACGGACTATAAGGATAA
ATCGGAAGAACGGCTGAACCTATA -> TCGGAAGAACGGCTGAACCTATAT
AAACGGCAGCAGCGACTCCCTACA -> AACGGCAGCAGCGACTCCCTACAG
AGCATTCCGCTTGTAAAAGCATGA -> GCATTCCGCTTGTAAAAGCATGAT
CCAATACGTTCTTCGTCCCATATT -> CAATACGTTCTTCGTCCCATATTC
GTTGATACAGTATCCTATATCACG -> TTGATACAGTATCCTATATCACGA
CGAAGGATATGCGGAAAGCTCAAG -> GAAGGATATGCGGAAAGCTCAAGA
CATCTGGTCCCCAAGCCCTCAGGC -> ATCTGGTCCCCAAGCCCTCAGGCT
GAATAGTCCGGGCGAATACATACC -> AATAGTCCGGGCGAATACATACCT
GGGCGAATACATACCTTGGCCTTT -> GGCGAATACATACCTTGGCCTTTG
GGTCTGGAACATGCTGGACATTTT -> GTCTGGAACATGCTGGACATTTTA
GGATCTAACCTTTTCGTACCTCAT -> GATCTAACCTTTTCGTACCTCATT
TCTTCCTGAATCACCTCACTATTA -> CTTCCTGAATCACCTCACTATTAG
TCAAAAATAGAATACCCCACATAC -> CAAAAATAGAATACCCCACATACG
CTCTCGCTTACTTAACGTAACGAA -> TCTCGCTTACTTAACGTAACGAAT
CAAACCAAGGTCATACAAAGAAGG -> AAACCAAGGTCATACAAAGAAGGG
GATCTAACCTTTTCGTACCTCATT -> ATCTAACCTTTTCGTACCTCATTA
ACACGGGTCGGAGCCAAGCGCACA -> CACGGGTCGGAGCCAAGCGCACAG
TTTGAAAACGTCTGAACCCATAGG -> TTGAAAACGTCTGAACCCATAGGT
TATCACTCCTACCCCCATCCAAAC -> ATCACTCCTACCCCCATCCAAACC
GTAACCGTGGTCTGTACCCGAGTG -> TAACCGTGGTCTGTACCCGAGTGA
TTGATACAGTATCCTATATCACGA -> TGATACAGTATCCTATATCACGAG
TTCAATTTTATTACTTGCCTTAGC -> TCAATTTTATTACTTGCCTTAGCT
ACGCATCCCCAAAGGCTGAACAGT -> CGCATCCCCAAAGGCTGAACAGTG
GTCGGCAACCATGGGAAACTGTTA -> TCGGCAACCATGGGAAACTGTTAA
TAGACTCTCGAAGGATATGCGGAA -> AGACTCTCGAAGGATATGCGGAAA
CATACGGTTTACAGGGCCTAAGGC -> ATACGGTTTACAGGGCCTAAGGCT
GAACGTCTACGGCCATGCTTCGGT -> AACGTCTACGGCCATGCTTCGGTC
TCACATCAAAAATCTTTCTTAAAT -> CACATCAAAAATCTTTCTTAAATA
GTATAATTAGTTCTGTCTTATTAT -> TATAATTAGTTCTGTCTTATTATG
CCCCATCCAAACCAAGGTCATACA -> CCCATCCAAACCAAGGTCATACAA
CGACTCCCTACAGCGGCGTCGCAA -> GACTCCCTACAGCGGCGTCGCAAG
ACGCTCACAGCAGTATGGGTGTAT -> CGCTCACAGCAGTATGGGTGTATC
ACCGCAATCAAGCGGTGGCGAGCG -> CCGCAATCAAGCGGTGGCGAGCGG
GTAAACAGAACTAAGAGACGTGCC -> TAAACAGAACTAAGAGACGTGCCA
TATGTACGGAGAAAAACAGGAGTG -> ATGTACGGAGAAAAACAGGAGTGA
TACTCATATGTACGGAGAAAAACA -> ACTCATATGTACGGAGAAAAACAG
CGCTTGTAAAAGCATGATCTCTGC -> GCTTGTAAAAGCATGATCTCTGCC
CGGTTGTCTAGATGGTTGATACAG -> GGTTGTCTAGATGGTTGATACAGT
CGGGTGTTACTAGCGCAACTTCGA -> GGGTGTTACTAGCGCAACTTCGAG
CCTATATTACTGACACATGCCAAC -> CTATATTACTGACACATGCCAACC
AAAAATCTTTCTTAAATAGACATG -> AAAATCTTTCTTAAATAGACATGG
GAGGCGTGTATTCCTCCACCACAG -> AGGCGTGTATTCCTCCACCACAGA
CCCTACCTGGATATTGGACCGTAC -> CCTACCTGGATATTGGACCGTACC
CAGCATTCCGCTTGTAAAAGCATG -> AGCATTCCGCTTGTAAAAGCATGA
TACAGCGGCGTCGCAAGAATCTCG -> ACAGCGGCGTCGCAAGAATCTCGT
ATGGGTGTATCGTGCAGAAAGGGA -> TGGGTGTATCGTGCAGAAAGGGAT
GCGGTAAACAGAACTAAGAGACGT -> CGGTAAACAGAACTAAGAGACGTG
AGAAAAACAGGAGTGACTGTCTAT -> GAAAAACAGGAGTGACTGTCTATG
TGAGCCACGGCCGGCCATCCAATG -> GAGCCACGGCCGGCCATCCAATGT
GTTCATTGTAGGCGTACCTGTCCC -> TTCATTGTAGGCGTACCTGTCCCG
TCCCGCGTCTCTTATGCTCACCAG -> CCCGCGTCTCTTATGCTCACCAGA
ACCTCATTACACACGGGTCGGAGC -> CCTCATTACACACGGGTCGGAGCC
CTGACACATGCCAACCTTGCTACA -> TGACACATGCCAACCTTGCTACAG
AAGAGGCCCTTCTATCCAGTTGTG -> AGAGGCCCTTCTATCCAGTTGTGT
GCATGATCTCTGCCCGTTTGTACT -> CATGATCTCTGCCCGTTTGTACTC
TCTCAGGGTCTGGAACATGCTGGA -> CTCAGGGTCTGGAACATGCTGGAC
ATTCCGCTTGTAAAAGCATGATCT -> TTCCGCTTGTAAAAGCATGATCTC
GCGAATACATACCTTGGCCTTTGT -> CGAATACATACCTTGGCCTTTGTA
TATTACTTGCCTTAGCTACCTTGG -> ATTACTTGCCTTAGCTACCTTGGT
CACAGAAAACTAGAAGAGGCCCTT -> ACAGAAAACTAGAAGAGGCCCTTC
CAGTTGTGTCCCTAATTCCGCCAG -> AGTTGTGTCCCTAATTCCGCCAGA
GGCCGCACCACGGACTATAAGGAT -> GCCGCACCACGGACTATAAGGATA
TCGCTTACTTAACGTAACGAATAG -> CGCTTACTTAACGTAACGAATAGT
ATTACTTGCCTTAGCTACCTTGGT -> TTACTTGCCTTAGCTACCTTGGTC
TCAATCGGAAGAACGGCTGAACCT -> CAATCGGAAGAACGGCTGAACCTA
ACAAAGAAGGGGAGCACAGCTATT -> CAAAGAAGGGGAGCACAGCTATTG
TATACATGATGCATCTTATCGTAA -> ATACATGATGCATCTTATCGTAAC
GGTCCGTTCTACTATACATGATGC -> GTCCGTTCTACTATACATGATGCA
TCGGCAACCATGGGAAACTGTTAA -> CGGCAACCATGGGAAACTGTTAAC
TCCCCAAGCCCTCAGGCTCTATGA -> CCCCAAGCCCTCAGGCTCTATGAT
GCGCGCGTTCGAACGTCTACGGCC -> CGCGCGTTCGAACGTCTACGGCCA
TCAAGCGGTGGCGAGCGGTAAACA -> CAAGCGGTGGCGAGCGGTAAACAG
TCGAGTAACATCACAAGAACTCCC -> CGAGTAACATCACAAGAACTCCCT
CACCACGGACTATAAGGATAACGA -> ACCACGGACTATAAGGATAACGAG
TTCCTGGTGAGCCACGGCCGGCCA -> TCCTGGTGAGCCACGGCCGGCCAT
CTGGATATTGGACCGTACCCCGAC -> TGGATATTGGACCGTACCCCGACA
ATACGACTACCTATATTACTGACA -> TACGACTACCTATATTACTGACAC
ACTTCGAGTAACATCACAAGAACT -> CTTCGAGTAACATCACAAGAACTC
AATACGTTCTTCGTCCCATATTCA -> ATACGTTCTTCGTCCCATATTCAT
TTCACATCAAAAATCTTTCTTAAA -> TCACATCAAAAATCTTTCTTAAAT
TAAATCACACTGGGGGGATCTTCC -> AAATCACACTGGGGGGATCTTCCT
CCAATGTATACGACTACCTATATT -> CAATGTATACGACTACCTATATTA
TAACAGTAGACTCTCGAAGGATAT -> AACAGTAGACTCTCGAAGGATATG
CTAGAAGAGGCCCTTCTATCCAGT -> TAGAAGAGGCCCTTCTATCCAGTT
CTCCCTACAGCGGCGTCGCAAGAA -> TCCCTACAGCGGCGTCGCAAGAAT
GCCTAAATCACACTGGGGGGATCT -> CCTAAATCACACTGGGGGGATCTT
AGGGATCTAACCTTTTCGTACCTC -> GGGATCTAACCTTTTCGTACCTCA
GCCTTAGCTACCTTGGTCCGTTCT -> CCTTAGCTACCTTGGTCCGTTCTA
TATGGGTGTATCGTGCAGAAAGGG -> ATGGGTGTATCGTGCAGAAAGGGA
AAGGATATGCGGAAAGCTCAAGAA -> AGGATATGCGGAAAGCTCAAGAAT
ACGTGCTGAACCGTTAACGACGGC -> CGTGCTGAACCGTTAACGACGGCG
GAGCCAAGCGCACAGTGGCTGCGC -> AGCCAAGCGCACAGTGGCTGCGCG
CGCAAGACGGCGCTTATGTCCCGC -> GCAAGACGGCGCTTATGTCCCGCG
CCGTTCTACTATACATGATGCATC -> CGTTCTACTATACATGATGCATCT
ACATCACAAGAACTCCCTCTTCAA -> CATCACAAGAACTCCCTCTTCAAT
TGGATATTGGACCGTACCCCGACA -> GGATATTGGACCGTACCCCGACAG
CTACGGCCATGCTTCGGTCGCATA -> TACGGCCATGCTTCGGTCGCATAC
GGACATTTTAATATCAGATGGTGG -> GACATTTTAATATCAGATGGTGGC
GGCGCCCTACCTGGATATTGGACC -> GCGCCCTACCTGGATATTGGACCG
CAGTATGGGTGTATCGTGCAGAAA -> AGTATGGGTGTATCGTGCAGAAAG
TGGGGGGATCTTCCTGAATCACCT -> GGGGGGATCTTCCTGAATCACCTC
CCTACCCCCATCCAAACCAAGGTC -> CTACCCCCATCCAAACCAAGGTCA
TCGAAGGATATGCGGAAAGCTCAA -> CGAAGGATATGCGGAAAGCTCAAG
AAGAACTCCCTCTTCAATTTTATT -> AGAACTCCCTCTTCAATTTTATTA
ATTTTAATATCAGATGGTGGCACA -> TTTTAATATCAGATGGTGGCACAT
CAAAAATCTTTCTTAAATAGACAT -> AAAAATCTTTCTTAAATAGACATG
GTGCAGAAAGGGATCTAACCTTTT -> TGCAGAAAGGGATCTAACCTTTTC
AACTGCCTTTCACATCAAAAATCT -> ACTGCCTTTCACATCAAAAATCTT
CCTCTTCAATTTTATTACTTGCCT -> CTCTTCAATTTTATTACTTGCCTT
GGTGGCACATTTTAACGCATCCCC -> GTGGCACATTTTAACGCATCCCCA
GCATCTTATCGTAACCGTGGTCTG -> CATCTTATCGTAACCGTGGTCTGT
TCTGTACCCGAGTGAAACGGCAGC -> CTGTACCCGAGTGAAACGGCAGCA
GTTACCTGGTCCCAGAATACTAAA -> TTACCTGGTCCCAGAATACTAAAT
AATGTATACGACTACCTATATTAC -> ATGTATACGACTACCTATATTACT
GGTTATCACTCCTACCCCCATCCA -> GTTATCACTCCTACCCCCATCCAA
AACATCACAAGAACTCCCTCTTCA -> ACATCACAAGAACTCCCTCTTCAA
ACAGCTATTGTTTCTTTAGTGTGA -> CAGCTATTGTTTCTTTAGTGTGAC
ACATCAAAAATCTTTCTTAAATAG -> CATCAAAAATCTTTCTTAAATAGA
TACGGAGAAAAACAGGAGTGACTG -> ACGGAGAAAAACAGGAGTGACTGT
TGTTCCAATACGTTCTTCGTCCCA -> GTTCCAATACGTTCTTCGTCCCAT
AGACGTGCCACATTTCATATATGC -> GACGTGCCACATTTCATATATGCG
AAAAGCCTAAATCACACTGGGGGG -> AAAGCCTAAATCACACTGGGGGGA
GTACCCGAGTGAAACGGCAGCAGC -> TACCCGAGTGAAACGGCAGCAGCG
AGAATACTAAATGTTAACAGTAGA -> GAATACTAAATGTTAACAGTAGAC
GCCATGCTTCGGTCGCATACTCAT -> CCATGCTTCGGTCGCATACTCATA
TTGTAAAAGCATGATCTCTGCCCG -> TGTAAAAGCATGATCTCTGCCCGT
GCTGAAATATTCCTGGTGAGCCAC -> CTGAAATATTCCTGGTGAGCCACG
CGAGTAACATCACAAGAACTCCCT -> GAGTAACATCACAAGAACTCCCTC
TTGCCTTAGCTACCTTGGTCCGTT -> TGCCTTAGCTACCTTGGTCCGTTC
ACTCTCGAAGGATATGCGGAAAGC -> CTCTCGAAGGATATGCGGAAAGCT
TCCTCCACCACAGAAAACTAGAAG -> CCTCCACCACAGAAAACTAGAAGA
TTCCTGAATCACCTCACTATTAGC -> TCCTGAATCACCTCACTATTAGCC
AGTATCCTATATCACGAGTGACAG -> GTATCCTATATCACGAGTGACAGG
CATTTCATATATGCGGGTGCCCGG -> ATTTCATATATGCGGGTGCCCGGC
TGCATCTTATCGTAACCGTGGTCT -> GCATCTTATCGTAACCGTGGTCTG
GCAGCAGCGACTCCCTACAGCGGC -> CAGCAGCGACTCCCTACAGCGGCG
CATATATGCGGGTGCCCGGCCGCA -> ATATATGCGGGTGCCCGGCCGCAC
AATCTTTCTTAAATAGACATGGTA -> ATCTTTCTTAAATAGACATGGTAC
ATTCCGCCAGAAAAGCCTAAATCA -> TTCCGCCAGAAAAGCCTAAATCAC
TGCTCACCAGATTGTTCCAATACG -> GCTCACCAGATTGTTCCAATACGT
CGTAACCGTGGTCTGTACCCGAGT -> GTAACCGTGGTCTGTACCCGAGTG
GCTGAACCTATATTCAGGCGGTTG -> CTGAACCTATATTCAGGCGGTTGT
GGATCTGGACCGCAATCAAGCGGT -> GATCTGGACCGCAATCAAGCGGTG
ACCGTACCCCGACAGAGTGCTTCC -> CCGTACCCCGACAGAGTGCTTCCC
CAGAAAACTAGAAGAGGCCCTTCT -> AGAAAACTAGAAGAGGCCCTTCTA
AGGCCCTTCTATCCAGTTGTGTCC -> GGCCCTTCTATCCAGTTGTGTCCC
CCCAAGCCCTCAGGCTCTATGATT -> CCAAGCCCTCAGGCTCTATGATTC
AATCACCTCACTATTAGCCTGAGT -> ATCACCTCACTATTAGCCTGAGTG
AAAGCTCAAGAATCCCGTCCTAGG -> AAGCTCAAGAATCCCGTCCTAGGT
ACAGTATCCTATATCACGAGTGAC -> CAGTATCCTATATCACGAGTGACA
GCCTGAGTGGGACGCTCACAGCAG -> CCTGAGTGGGACGCTCACAGCAGT
AGCCTGAGTGGGACGCTCACAGCA -> GCCTGAGTGGGACGCTCACAGCAG
CATACAAAGAAGGGGAGCACAGCT -> ATACAAAGAAGGGGAGCACAGCTA
CACTCCTACCCCCATCCAAACCAA -> ACTCCTACCCCCATCCAAACCAAG
GGTCCTGACGTGCTGAACCGTTAA -> GTCCTGACGTGCTGAACCGTTAAC
CCCCACATACGGTTTACAGGGCCT -> CCCACATACGGTTTACAGGGCCTA
TTGAACTGCCTTTCACATCAAAAA -> TGAACTGCCTTTCACATCAAAAAT
CGTTCTACTATACATGATGCATCT -> GTTCTACTATACATGATGCATCTT
GTGCTTCCCTCTGTCAAGAAATCA -> TGCTTCCCTCTGTCAAGAAATCAA
AATGTTAACAGTAGACTCTCGAAG -> ATGTTAACAGTAGACTCTCGAAGG
GGCCGGGTTACCTGGTCCCAGAAT -> GCCGGGTTACCTGGTCCCAGAATA
TCCCAGAATACTAAATGTTAACAG -> CCCAGAATACTAAATGTTAACAGT
ATGGTTGATACAGTATCCTATATC -> TGGTTGATACAGTATCCTATATCA
TCCTGAATCACCTCACTATTAGCC -> CCTGAATCACCTCACTATTAGCCT
AAAAATAGAATACCCCACATACGG -> AAAATAGAATACCCCACATACGGT
TAGAATACCCCACATACGGTTTAC -> AGAATACCCCACATACGGTTTACA
GAACCTATATTCAGGCGGTTGTCT -> AACCTATATTCAGGCGGTTGTCTA
AAAAACAGGAGTGACTGTCTATGA -> AAAACAGGAGTGACTGTCTATGAT
ACGGTTTACAGGGCCTAAGGCTAT -> CGGTTTACAGGGCCTAAGGCTATC
TCACCTCACTATTAGCCTGAGTGG -> CACCTCACTATTAGCCTGAGTGGG
CCGAGTGAAACGGCAGCAGCGACT -> CGAGTGAAACGGCAGCAGCGACTC
GCAAGAATCTCGTTTCCCTTTGAA -> CAAGAATCTCGTTTCCCTTTGAAA
ACAGCAGTATGGGTGTATCGTGCA -> CAGCAGTATGGGTGTATCGTGCAG
TTGTTTCTTTAGTGTGACCCGGGT -> TGTTTCTTTAGTGTGACCCGGGTG
GACAGGATTGGTTCAAAAATAGAA -> ACAGGATTGGTTCAAAAATAGAAT
AGGATCTGGACCGCAATCAAGCGG -> GGATCTGGACCGCAATCAAGCGGT
ACTCTTAAATGGGTGAGTTCATTG -> CTCTTAAATGGGTGAGTTCATTGT
TCGTTTCCCTTTGAAAGGGCCGCA -> CGTTTCCCTTTGAAAGGGCCGCAA
CCCTCTGTCAAGAAATCAATCGGA -> CCTCTGTCAAGAAATCAATCGGAA
CTCTCGAAGGATATGCGGAAAGCT -> TCTCGAAGGATATGCGGAAAGCTC
TTTTAACGCATCCCCAAAGGCTGA -> TTTAACGCATCCCCAAAGGCTGAA
GGGTGAGTTCATTGTAGGCGTACC -> GGTGAGTTCATTGTAGGCGTACCT
ATTCAGGCGGTTGTCTAGATGGTT -> TTCAGGCGGTTGTCTAGATGGTTG
CACCACAGAAAACTAGAAGAGGCC -> ACCACAGAAAACTAGAAGAGGCCC
GTGGTCTGTACCCGAGTGAAACGG -> TGGTCTGTACCCGAGTGAAACGGC
GGCGTACCTGTCCCGTCGGCAACC -> GCGTACCTGTCCCGTCGGCAACCA
GGATAACGAGGCGTGTATTCCTCC -> GATAACGAGGCGTGTATTCCTCCA
ACCATGCCTTCTCAGGGTCTGGAA -> CCATGCCTTCTCAGGGTCTGGAAC
TGTATCGTGCAGAAAGGGATCTAA -> GTATCGTGCAGAAAGGGATCTAAC
GGACGGACATTGAACTGCCTTTCA -> GACGGACATTGAACTGCCTTTCAC
TACTCACCCTCGCAATTAGGATCT -> ACTCACCCTCGCAATTAGGATCTG
ACCTTTTCGTACCTCATTACACAC -> CCTTTTCGTACCTCATTACACACG
TATTCATATGCTTGCTGAAATATT -> ATTCATATGCTTGCTGAAATATTC
ACCCCGACAGAGTGCTTCCCTCTG -> CCCCGACAGAGTGCTTCCCTCTGT
AAGGATAACGAGGCGTGTATTCCT -> AGGATAACGAGGCGTGTATTCCTC
CCATGCTTCGGTCGCATACTCATA -> CATGCTTCGGTCGCATACTCATAT
CCAGAATACTAAATGTTAACAGTA -> CAGAATACTAAATGTTAACAGTAG
GGGGATCTTCCTGAATCACCTCAC -> GGGATCTTCCTGAATCACCTCACT
TGGTTCAAAAATAGAATACCCCAC -> GGTTCAAAAATAGAATACCCCACA
TTAACGTAACGAATAGTCCGGGCG -> TAACGTAACGAATAGTCCGGGCGA
CTCATATGTACGGAGAAAAACAGG -> TCATATGTACGGAGAAAAACAGGA
GGCTGAACCTATATTCAGGCGGTT -> GCTGAACCTATATTCAGGCGGTTG
TCACCCTCGCAATTAGGATCTGGA -> CACCCTCGCAATTAGGATCTGGAC
ATACATACCTTGGCCTTTGTACTC -> TACATACCTTGGCCTTTGTACTCA
GAGTGAAACGGCAGCAGCGACTCC -> AGTGAAACGGCAGCAGCGACTCCC
CCCCCATCCAAACCAAGGTCATAC -> CCCCATCCAAACCAAGGTCATACA
GGTCAACCATGCCTTCTCAGGGTC -> GTCAACCATGCCTTCTCAGGGTCT
CTGCCTTTCACATCAAAAATCTTT -> TGCCTTTCACATCAAAAATCTTTC
TTACTAGCGCAACTTCGAGTAACA -> TACTAGCGCAACTTCGAGTAACAT
CGACGGCGGCGCCCTACCTGGATA -> GACGGCGGCGCCCTACCTGGATAT
GAGTGACAGGATTGGTTCAAAAAT -> AGTGACAGGATTGGTTCAAAAATA
CGACAGAGTGCTTCCCTCTGTCAA -> GACAGAGTGCTTCCCTCTGTCAAG
GGTACCGCTTTATCATCTGGTCCC -> GTACCGCTTTATCATCTGGTCCCC
CGTTCTTCGTCCCATATTCATATG -> GTTCTTCGTCCCATATTCATATGC
TCCCTTTGAAAGGGCCGCAAGACG -> CCCTTTGAAAGGGCCGCAAGACGG
CTAAGGCTATCGAAAACAAGCAAG -> TAAGGCTATCGAAAACAAGCAAGG
TTATGCTCTCGCTTACTTAACGTA -> TATGCTCTCGCTTACTTAACGTAA
TGCTACAGCATTCCGCTTGTAAAA -> GCTACAGCATTCCGCTTGTAAAAG
GTATCGTGCAGAAAGGGATCTAAC -> TATCGTGCAGAAAGGGATCTAACC
GATTGGTTCAAAAATAGAATACCC -> ATTGGTTCAAAAATAGAATACCCC
GCTTCCCTCTGTCAAGAAATCAAT -> CTTCCCTCTGTCAAGAAATCAATC
ATACCTTGGCCTTTGTACTCACCC -> TACCTTGGCCTTTGTACTCACCCT
TGTCCCGCGTCTCTTATGCTCACC -> GTCCCGCGTCTCTTATGCTCACCA
GTAAAGGACGGACATTGAACTGCC -> TAAAGGACGGACATTGAACTGCCT
CCGTCGGCAACCATGGGAAACTGT -> CGTCGGCAACCATGGGAAACTGTT
GGCGGTTGTCTAGATGGTTGATAC -> GCGGTTGTCTAGATGGTTGATACA
CTTCTATCCAGTTGTGTCCCTAAT -> TTCTATCCAGTTGTGTCCCTAATT
TGACACATGCCAACCTTGCTACAG -> GACACATGCCAACCTTGCTACAGC
CACAGCTATTGTTTCTTTAGTGTG -> ACAGCTATTGTTTCTTTAGTGTGA
CGTGGTCTGTACCCGAGTGAAACG -> GTGGTCTGTACCCGAGTGAAACGG
GGGCCGCAAGACGGCGCTTATGTC -> GGCCGCAAGACGGCGCTTATGTCC
GCGCTTATGTCCCGCGTCTCTTAT -> CGCTTATGTCCCGCGTCTCTTATG
TACATACCTTGGCCTTTGTACTCA -> ACATACCTTGGCCTTTGTACTCAC
CTAAATCACACTGGGGGGATCTTC -> TAAATCACACTGGGGGGATCTTCC
TATCCTATATCACGAGTGACAGGA -> ATCCTATATCACGAGTGACAGGAT
AAAACGTCTGAACCCATAGGTTAT -> AAACGTCTGAACCCATAGGTTATC
ACGGCGGCGCCCTACCTGGATATT -> CGGCGGCGCCCTACCTGGATATTG
AATTAGGATCTGGACCGCAATCAA -> ATTAGGATCTGGACCGCAATCAAG
AGGGGAGCACAGCTATTGTTTCTT -> GGGGAGCACAGCTATTGTTTCTTT
AACCATGCCTTCTCAGGGTCTGGA -> ACCATGCCTTCTCAGGGTCTGGAA
GGCGAATACATACCTTGGCCTTTG -> GCGAATACATACCTTGGCCTTTGT
ACTAGAAGAGGCCCTTCTATCCAG -> CTAGAAGAGGCCCTTCTATCCAGT
TCCCCAAAGGCTGAACAGTGGCTC -> CCCCAAAGGCTGAACAGTGGCTCG
GGGAGCACAGCTATTGTTTCTTTA -> GGAGCACAGCTATTGTTTCTTTAG
GTATACGACTACCTATATTACTGA -> TATACGACTACCTATATTACTGAC
TCCTGACGTGCTGAACCGTTAACG -> CCTGACGTGCTGAACCGTTAACGA
ACGGACTATAAGGATAACGAGGCG -> CGGACTATAAGGATAACGAGGCGT
ATTAGTTCTGTCTTATTATGCTCT -> TTAGTTCTGTCTTATTATGCTCTC
TTTCATATATGCGGGTGCCCGGCC -> TTCATATATGCGGGTGCCCGGCCG
GGTCCCCAAGCCCTCAGGCTCTAT -> GTCCCCAAGCCCTCAGGCTCTATG
CGTCTACGGCCATGCTTCGGTCGC -> GTCTACGGCCATGCTTCGGTCGCA
TGGTCCCAGAATACTAAATGTTAA -> GGTCCCAGAATACTAAATGTTAAC
GGTAAAGGACGGACATTGAACTGC -> GTAAAGGACGGACATTGAACTGCC
AATATTCCTGGTGAGCCACGGCCG -> ATATTCCTGGTGAGCCACGGCCGG
CCGCTTTATCATCTGGTCCCCAAG -> CGCTTTATCATCTGGTCCCCAAGC
GGTGCCCGGCCGCACCACGGACTA -> GTGCCCGGCCGCACCACGGACTAT
CATATTCATATGCTTGCTGAAATA -> ATATTCATATGCTTGCTGAAATAT
ATAGTCCGGGCGAATACATACCTT -> TAGTCCGGGCGAATACATACCTTG
GGTTGATACAGTATCCTATATCAC -> GTTGATACAGTATCCTATATCACG
TTTCGTACCTCATTACACACGGGT -> TTCGTACCTCATTACACACGGGTC
CGAGGCGTGTATTCCTCCACCACA -> GAGGCGTGTATTCCTCCACCACAG
GCAATTAGGATCTGGACCGCAATC -> CAATTAGGATCTGGACCGCAATCA
GGCTCGGAATTTGAAAACGTCTGA -> GCTCGGAATTTGAAAACGTCTGAA
GCGCCCTACCTGGATATTGGACCG -> CGCCCTACCTGGATATTGGACCGT
GGTTCAAAAATAGAATACCCCACA -> GTTCAAAAATAGAATACCCCACAT
ATTAGGATCTGGACCGCAATCAAG -> TTAGGATCTGGACCGCAATCAAGC
TACGTTCTTCGTCCCATATTCATA -> ACGTTCTTCGTCCCATATTCATAT
AACCCATAGGTTATCACTCCTACC -> ACCCATAGGTTATCACTCCTACCC
CCCAGAATACTAAATGTTAACAGT -> CCAGAATACTAAATGTTAACAGTA
GAAGGGGAGCACAGCTATTGTTTC -> AAGGGGAGCACAGCTATTGTTTCT
GATATGCGGAAAGCTCAAGAATCC -> ATATGCGGAAAGCTCAAGAATCCC
GAGTTCATTGTAGGCGTACCTGTC -> AGTTCATTGTAGGCGTACCTGTCC
GTGAGTTCATTGTAGGCGTACCTG -> TGAGTTCATTGTAGGCGTACCTGT
TGGCACATTTTAACGCATCCCCAA -> GGCACATTTTAACGCATCCCCAAA
CGCACCACGGACTATAAGGATAAC -> GCACCACGGACTATAAGGATAACG
CTATATTACTGACACATGCCAACC -> TATATTACTGACACATGCCAACCT
CCTGAGTGGGACGCTCACAGCAGT -> CTGAGTGGGACGCTCACAGCAGTA
CGGACATTGAACTGCCTTTCACAT -> GGACATTGAACTGCCTTTCACATC
GTCCGTTCTACTATACATGATGCA -> TCCGTTCTACTATACATGATGCAT
AAGAAATCAATCGGAAGAACGGCT -> AGAAATCAATCGGAAGAACGGCTG
GCTGGACATTTTAATATCAGATGG -> CTGGACATTTTAATATCAGATGGT
CCATAGGTTATCACTCCTACCCCC -> CATAGGTTATCACTCCTACCCCCA
CCAAACCAAGGTCATACAAAGAAG -> CAAACCAAGGTCATACAAAGAAGG
GCTCGGAATTTGAAAACGTCTGAA -> CTCGGAATTTGAAAACGTCTGAAC
CCTATATCACGAGTGACAGGATTG -> CTATATCACGAGTGACAGGATTGG
CACCTCACTATTAGCCTGAGTGGG -> ACCTCACTATTAGCCTGAGTGGGA
CGGCAACCATGGGAAACTGTTAAC -> GGCAACCATGGGAAACTGTTAACC
GGTCGGAGCCAAGCGCACAGTGGC -> GTCGGAGCCAAGCGCACAGTGGCT
CGGAAGAACGGCTGAACCTATATT -> GGAAGAACGGCTGAACCTATATTC
CCCCAAGCCCTCAGGCTCTATGAT -> CCCAAGCCCTCAGGCTCTATGATT
AGCAGCGACTCCCTACAGCGGCGT -> GCAGCGACTCCCTACAGCGGCGTC
CAAGAATCTCGTTTCCCTTTGAAA -> AAGAATCTCGTTTCCCTTTGAAAG
TACTTAACGTAACGAATAGTCCGG -> ACTTAACGTAACGAATAGTCCGGG
CCCCGACAGAGTGCTTCCCTCTGT -> CCCGACAGAGTGCTTCCCTCTGTC
CCCGTTTGTACTCTTAAATGGGTG -> CCGTTTGTACTCTTAAATGGGTGA
ATCACTCCTACCCCCATCCAAACC -> TCACTCCTACCCCCATCCAAACCA
AGGCCGGGTTACCTGGTCCCAGAA -> GGCCGGGTTACCTGGTCCCAGAAT
TCCCTCTTCAATTTTATTACTTGC -> CCCTCTTCAATTTTATTACTTGCC
CCATCCAATGTATACGACTACCTA -> CATCCAATGTATACGACTACCTAT
ACGTTCTTCGTCCCATATTCATAT -> CGTTCTTCGTCCCATATTCATATG
GCTTACTTAACGTAACGAATAGTC -> CTTACTTAACGTAACGAATAGTCC
ATCACGAGTGACAGGATTGGTTCA -> TCACGAGTGACAGGATTGGTTCAA
GTAAAAGCATGATCTCTGCCCGTT -> TAAAAGCATGATCTCTGCCCGTTT
CCCACATACGGTTTACAGGGCCTA -> CCACATACGGTTTACAGGGCCTAA
CTTATTATGCTCTCGCTTACTTAA -> TTATTATGCTCTCGCTTACTTAAC
CGTAACGAATAGTCCGGGCGAATA -> GTAACGAATAGTCCGGGCGAATAC
CGTCCCATATTCATATGCTTGCTG -> GTCCCATATTCATATGCTTGCTGA
ACCACAGAAAACTAGAAGAGGCCC -> CCACAGAAAACTAGAAGAGGCCCT
CATCCCCAAAGGCTGAACAGTGGC -> ATCCCCAAAGGCTGAACAGTGGCT
CCACATTTCATATATGCGGGTGCC -> CACATTTCATATATGCGGGTGCCC
TTGAAAGGGCCGCAAGACGGCGCT -> TGAAAGGGCCGCAAGACGGCGCTT
TATAATTAGTTCTGTCTTATTATG -> ATAATTAGTTCTGTCTTATTATGC
GACGTGCTGAACCGTTAACGACGG -> ACGTGCTGAACCGTTAACGACGGC
CTGTCTTATTATGCTCTCGCTTAC -> TGTCTTATTATGCTCTCGCTTACT
TTACACACGGGTCGGAGCCAAGCG -> TACACACGGGTCGGAGCCAAGCGC
TCTAACCTTTTCGTACCTCATTAC -> CTAACCTTTTCGTACCTCATTACA
GACACATGCCAACCTTGCTACAGC -> ACACATGCCAACCTTGCTACAGCA
ACGTAACGAATAGTCCGGGCGAAT -> CGTAACGAATAGTCCGGGCGAATA
TATGATTGGTCCTGACGTGCTGAA -> ATGATTGGTCCTGACGTGCTGAAC
AGCGGTGGCGAGCGGTAAACAGAA -> GCGGTGGCGAGCGGTAAACAGAAC
CGTTCGAACGTCTACGGCCATGCT -> GTTCGAACGTCTACGGCCATGCTT
TCTTTAGTGTGACCCGGGTGTTAC -> CTTTAGTGTGACCCGGGTGTTACT
TTACTGACACATGCCAACCTTGCT -> TACTGACACATGCCAACCTTGCTA
CCCTCAGGCTCTATGATTCCCAGG -> CCTCAGGCTCTATGATTCCCAGGT
AGTGGCTCGGAATTTGAAAACGTC -> GTGGCTCGGAATTTGAAAACGTCT
CGTGTATTCCTCCACCACAGAAAA -> GTGTATTCCTCCACCACAGAAAAC
TGAAATATTCCTGGTGAGCCACGG -> GAAATATTCCTGGTGAGCCACGGC
CACATACGGTTTACAGGGCCTAAG -> ACATACGGTTTACAGGGCCTAAGG
AAGAGACGTGCCACATTTCATATA -> AGAGACGTGCCACATTTCATATAT
GTCCCCAAGCCCTCAGGCTCTATG -> TCCCCAAGCCCTCAGGCTCTATGA
CATGCCAACCTTGCTACAGCATTC -> ATGCCAACCTTGCTACAGCATTCC
CAATTAGGATCTGGACCGCAATCA -> AATTAGGATCTGGACCGCAATCAA
GCCGGGTTACCTGGTCCCAGAATA -> CCGGGTTACCTGGTCCCAGAATAC
ACCTATATTCAGGCGGTTGTCTAG -> CCTATATTCAGGCGGTTGTCTAGA
CGGGTCGGAGCCAAGCGCACAGTG -> GGGTCGGAGCCAAGCGCACAGTGG
TACTAGCGCAACTTCGAGTAACAT -> ACTAGCGCAACTTCGAGTAACATC
TGCCTTCTCAGGGTCTGGAACATG -> GCCTTCTCAGGGTCTGGAACATGC
GTGCCACATTTCATATATGCGGGT -> TGCCACATTTCATATATGCGGGTG
CACAGCAGTATGGGTGTATCGTGC -> ACAGCAGTATGGGTGTATCGTGCA
GCTGAACCGTTAACGACGGCGGCG -> CTGAACCGTTAACGACGGCGGCGC
GACGGCGCTTATGTCCCGCGTCTC -> ACGGCGCTTATGTCCCGCGTCTCT
ACGTCTGAACCCATAGGTTATCAC -> CGTCTGAACCCATAGGTTATCACT
AAATGTTAACAGTAGACTCTCGAA -> AATGTTAACAGTAGACTCTCGAAG
AGGCGTGTATTCCTCCACCACAGA -> GGCGTGTATTCCTCCACCACAGAA
GATATTGGACCGTACCCCGACAGA -> ATATTGGACCGTACCCCGACAGAG
ATGCTTCGGTCGCATACTCATATG -> TGCTTCGGTCGCATACTCATATGT
TTCTTTAGTGTGACCCGGGTGTTA -> TCTTTAGTGTGACCCGGGTGTTAC
ATGCCTTCTCAGGGTCTGGAACAT -> TGCCTTCTCAGGGTCTGGAACATG
CGCAAGAATCTCGTTTCCCTTTGA -> GCAAGAATCTCGTTTCCCTTTGAA
CCCATAGGTTATCACTCCTACCCC -> CCATAGGTTATCACTCCTACCCCC
GATAACGAGGCGTGTATTCCTCCA -> ATAACGAGGCGTGTATTCCTCCAC
TCTCGAAGGATATGCGGAAAGCTC -> CTCGAAGGATATGCGGAAAGCTCA
GTCTCTTATGCTCACCAGATTGTT -> TCTCTTATGCTCACCAGATTGTTC
TGGCGAGCGGTAAACAGAACTAAG -> GGCGAGCGGTAAACAGAACTAAGA
ACGGCGCTTATGTCCCGCGTCTCT -> CGGCGCTTATGTCCCGCGTCTCTT
GGGATCTAACCTTTTCGTACCTCA -> GGATCTAACCTTTTCGTACCTCAT
TCACACTGGGGGGATCTTCCTGAA -> CACACTGGGGGGATCTTCCTGAAT
TGTACTCACCCTCGCAATTAGGAT -> GTACTCACCCTCGCAATTAGGATC
ACAGGATTGGTTCAAAAATAGAAT -> CAGGATTGGTTCAAAAATAGAATA
CTTATGCTCACCAGATTGTTCCAA -> TTATGCTCACCAGATTGTTCCAAT
TACCTCATTACACACGGGTCGGAG -> ACCTCATTACACACGGGTCGGAGC
GCTTTATCATCTGGTCCCCAAGCC -> CTTTATCATCTGGTCCCCAAGCCC
TAAGGCTATCGAAAACAAGCAAGG -> AAGGCTATCGAAAACAAGCAAGGC
GTTCGAACGTCTACGGCCATGCTT -> TTCGAACGTCTACGGCCATGCTTC
CTACCCCCATCCAAACCAAGGTCA -> TACCCCCATCCAAACCAAGGTCAT
AACTCCCTCTTCAATTTTATTACT -> ACTCCCTCTTCAATTTTATTACTT
ACAGCGGCGTCGCAAGAATCTCGT -> CAGCGGCGTCGCAAGAATCTCGTT
AGCTCAAGAATCCCGTCCTAGGTT -> GCTCAAGAATCCCGTCCTAGGTTG
TAGCTACCTTGGTCCGTTCTACTA -> AGCTACCTTGGTCCGTTCTACTAT
CATCTTATCGTAACCGTGGTCTGT -> ATCTTATCGTAACCGTGGTCTGTA
TCGCATACTCATATGTACGGAGAA -> CGCATACTCATATGTACGGAGAAA
TATGCTCACCAGATTGTTCCAATA -> ATGCTCACCAGATTGTTCCAATAC
ATTGGTCCTGACGTGCTGAACCGT -> TTGGTCCTGACGTGCTGAACCGTT
ATTGTTCCAATACGTTCTTCGTCC -> TTGTTCCAATACGTTCTTCGTCCC
TCTTCAATTTTATTACTTGCCTTA -> CTTCAATTTTATTACTTGCCTTAG
CAAGAAATCAATCGGAAGAACGGC -> AAGAAATCAATCGGAAGAACGGCT
GCCCTCAGGCTCTATGATTCCCAG -> CCCTCAGGCTCTATGATTCCCAGG
TATGTCCCGCGTCTCTTATGCTCA -> ATGTCCCGCGTCTCTTATGCTCAC
TGACGTGCTGAACCGTTAACGACG -> GACGTGCTGAACCGTTAACGACGG
AGATGGTGGCACATTTTAACGCAT -> GATGGTGGCACATTTTAACGCATC
GTGTATTCCTCCACCACAGAAAAC -> TGTATTCCTCCACCACAGAAAACT
TCCGCTTGTAAAAGCATGATCTCT -> CCGCTTGTAAAAGCATGATCTCTG
GACTCCCTACAGCGGCGTCGCAAG -> ACTCCCTACAGCGGCGTCGCAAGA
TTTATTACTTGCCTTAGCTACCTT -> TTATTACTTGCCTTAGCTACCTTG
ATACGTTCTTCGTCCCATATTCAT -> TACGTTCTTCGTCCCATATTCATA
CAAGACGGCGCTTATGTCCCGCGT -> AAGACGGCGCTTATGTCCCGCGTC
GGCCCTTCTATCCAGTTGTGTCCC -> GCCCTTCTATCCAGTTGTGTCCCT
GGAATTTGAAAACGTCTGAACCCA -> GAATTTGAAAACGTCTGAACCCAT
CGGCGGCGCCCTACCTGGATATTG -> GGCGGCGCCCTACCTGGATATTGG
TGGACCGCAATCAAGCGGTGGCGA -> GGACCGCAATCAAGCGGTGGCGAG
TATGCTCTCGCTTACTTAACGTAA -> ATGCTCTCGCTTACTTAACGTAAC
CTGGACATTTTAATATCAGATGGT -> TGGACATTTTAATATCAGATGGTG
CGGGTTACCTGGTCCCAGAATACT -> GGGTTACCTGGTCCCAGAATACTA
GATTGGTCCTGACGTGCTGAACCG -> ATTGGTCCTGACGTGCTGAACCGT
AGCGCAACTTCGAGTAACATCACA -> GCGCAACTTCGAGTAACATCACAA
TTGCTACAGCATTCCGCTTGTAAA -> TGCTACAGCATTCCGCTTGTAAAA
ACCCATAGGTTATCACTCCTACCC -> CCCATAGGTTATCACTCCTACCCC
CTGAACCTATATTCAGGCGGTTGT -> TGAACCTATATTCAGGCGGTTGTC
CGAATAGTCCGGGCGAATACATAC -> GAATAGTCCGGGCGAATACATACC
GCGTGTATTCCTCCACCACAGAAA -> CGTGTATTCCTCCACCACAGAAAA
TGATTCCCAGGTCAACCATGCCTT -> GATTCCCAGGTCAACCATGCCTTC
CTCAGGGTCTGGAACATGCTGGAC -> TCAGGGTCTGGAACATGCTGGACA
AAAATAGAATACCCCACATACGGT -> AAATAGAATACCCCACATACGGTT
ATACCCCACATACGGTTTACAGGG -> TACCCCACATACGGTTTACAGGGC
TGTAAAAGCATGATCTCTGCCCGT -> GTAAAAGCATGATCTCTGCCCGTT
ATACTAAATGTTAACAGTAGACTC -> TACTAAATGTTAACAGTAGACTCT
CGCTTACTTAACGTAACGAATAGT -> GCTTACTTAACGTAACGAATAGTC
CGTCTGAACCCATAGGTTATCACT -> GTCTGAACCCATAGGTTATCACTC
TGGCCTTTGTACTCACCCTCGCAA -> GGCCTTTGTACTCACCCTCGCAAT
TGGAACATGCTGGACATTTTAATA -> GGAACATGCTGGACATTTTAATAT
CGGCCGCACCACGGACTATAAGGA -> GGCCGCACCACGGACTATAAGGAT
TCTGGAACATGCTGGACATTTTAA -> CTGGAACATGCTGGACATTTTAAT
ATATTACTGACACATGCCAACCTT -> TATTACTGACACATGCCAACCTTG
ATGCGGGTGCCCGGCCGCACCACG -> TGCGGGTGCCCGGCCGCACCACGG
GTTCTTCGTCCCATATTCATATGC -> TTCTTCGTCCCATATTCATATGCT
GCTGAACAGTGGCTCGGAATTTGA -> CTGAACAGTGGCTCGGAATTTGAA
AAGGGATCTAACCTTTTCGTACCT -> AGGGATCTAACCTTTTCGTACCTC
AGAACGGCTGAACCTATATTCAGG -> GAACGGCTGAACCTATATTCAGGC
ACATGATGCATCTTATCGTAACCG -> CATGATGCATCTTATCGTAACCGT
TCTGTCTTATTATGCTCTCGCTTA -> CTGTCTTATTATGCTCTCGCTTAC
ATATATGCGGGTGCCCGGCCGCAC -> TATATGCGGGTGCCCGGCCGCACC
CCACGGCCGGCCATCCAATGTATA -> CACGGCCGGCCATCCAATGTATAC
GTTCTGTCTTATTATGCTCTCGCT -> TTCTGTCTTATTATGCTCTCGCTT
AATTCCGCCAGAAAAGCCTAAATC -> ATTCCGCCAGAAAAGCCTAAATCA
ACTAAATGTTAACAGTAGACTCTC -> CTAAATGTTAACAGTAGACTCTCG
CACGGACTATAAGGATAACGAGGC -> ACGGACTATAAGGATAACGAGGCG
GCGGCGCCCTACCTGGATATTGGA -> CGGCGCCCTACCTGGATATTGGAC
AGAATACCCCACATACGGTTTACA -> GAATACCCCACATACGGTTTACAG
CTGTACCCGAGTGAAACGGCAGCA -> TGTACCCGAGTGAAACGGCAGCAG
GTACGGAGAAAAACAGGAGTGACT -> TACGGAGAAAAACAGGAGTGACTG
CACATGCCAACCTTGCTACAGCAT -> ACATGCCAACCTTGCTACAGCATT
AGAAAGGGATCTAACCTTTTCGTA -> GAAAGGGATCTAACCTTTTCGTAC
CCGTATAATTAGTTCTGTCTTATT -> CGTATAATTAGTTCTGTCTTATTA
CGGAAAGCTCAAGAATCCCGTCCT -> GGAAAGCTCAAGAATCCCGTCCTA
AACCGTATAATTAGTTCTGTCTTA -> ACCGTATAATTAGTTCTGTCTTAT
ACGGCAGCAGCGACTCCCTACAGC -> CGGCAGCAGCGACTCCCTACAGCG
ATGATGCATCTTATCGTAACCGTG -> TGATGCATCTTATCGTAACCGTGG
TTAACCGTATAATTAGTTCTGTCT -> TAACCGTATAATTAGTTCTGTCTT
CCCTAATTCCGCCAGAAAAGCCTA -> CCTAATTCCGCCAGAAAAGCCTAA
CGGCCATCCAATGTATACGACTAC -> GGCCATCCAATGTATACGACTACC
AGGCTGAACAGTGGCTCGGAATTT -> GGCTGAACAGTGGCTCGGAATTTG
CTATCGAAAACAAGCAAGGCCGGG -> TATCGAAAACAAGCAAGGCCGGGT
GGCCTTTGTACTCACCCTCGCAAT -> GCCTTTGTACTCACCCTCGCAATT
GACAGAGTGCTTCCCTCTGTCAAG -> ACAGAGTGCTTCCCTCTGTCAAGA
CATCAAAAATCTTTCTTAAATAGA -> ATCAAAAATCTTTCTTAAATAGAC
CTGAACCGTTAACGACGGCGGCGC -> TGAACCGTTAACGACGGCGGCGCC
GGCCTAAGGCTATCGAAAACAAGC -> GCCTAAGGCTATCGAAAACAAGCA
TCCTATATCACGAGTGACAGGATT -> CCTATATCACGAGTGACAGGATTG
GTCCGGGCGAATACATACCTTGGC -> TCCGGGCGAATACATACCTTGGCC
GAGCACAGCTATTGTTTCTTTAGT -> AGCACAGCTATTGTTTCTTTAGTG
CCACCACAGAAAACTAGAAGAGGC -> CACCACAGAAAACTAGAAGAGGCC
GGTTGTCTAGATGGTTGATACAGT -> GTTGTCTAGATGGTTGATACAGTA
GATGCATCTTATCGTAACCGTGGT -> ATGCATCTTATCGTAACCGTGGTC
CAGCGACTCCCTACAGCGGCGTCG -> AGCGACTCCCTACAGCGGCGTCGC
AGTAGACTCTCGAAGGATATGCGG -> GTAGACTCTCGAAGGATATGCGGA
CCTTGCTACAGCATTCCGCTTGTA -> CTTGCTACAGCATTCCGCTTGTAA
CATTGAACTGCCTTTCACATCAAA -> ATTGAACTGCCTTTCACATCAAAA
CCTTTCACATCAAAAATCTTTCTT -> CTTTCACATCAAAAATCTTTCTTA
GAGTGACTGTCTATGATTGGTCCT -> AGTGACTGTCTATGATTGGTCCTG
CCAAGGTCATACAAAGAAGGGGAG -> CAAGGTCATACAAAGAAGGGGAGC
TGAAAACGTCTGAACCCATAGGTT -> GAAAACGTCTGAACCCATAGGTTA
AGAATCTCGTTTCCCTTTGAAAGG -> GAATCTCGTTTCCCTTTGAAAGGG
TAAATGTTAACAGTAGACTCTCGA -> AAATGTTAACAGTAGACTCTCGAA
CGTATAATTAGTTCTGTCTTATTA -> GTATAATTAGTTCTGTCTTATTAT
CTCCACCACAGAAAACTAGAAGAG -> TCCACCACAGAAAACTAGAAGAGG
TACCGCTTTATCATCTGGTCCCCA -> ACCGCTTTATCATCTGGTCCCCAA
TCACGAGTGACAGGATTGGTTCAA -> CACGAGTGACAGGATTGGTTCAAA
AGACATGGTACCGCTTTATCATCT -> GACATGGTACCGCTTTATCATCTG
CACGGCCGGCCATCCAATGTATAC -> ACGGCCGGCCATCCAATGTATACG
GTCTATGATTGGTCCTGACGTGCT -> TCTATGATTGGTCCTGACGTGCTG
ACGAGTGACAGGATTGGTTCAAAA -> CGAGTGACAGGATTGGTTCAAAAA
GCCTTCTCAGGGTCTGGAACATGC -> CCTTCTCAGGGTCTGGAACATGCT
TACCCCACATACGGTTTACAGGGC -> ACCCCACATACGGTTTACAGGGCC
ACTCATATGTACGGAGAAAAACAG -> CTCATATGTACGGAGAAAAACAGG
TTTTAATATCAGATGGTGGCACAT -> TTTAATATCAGATGGTGGCACATT
ACCTGTCCCGTCGGCAACCATGGG -> CCTGTCCCGTCGGCAACCATGGGA
ATCTAACCTTTTCGTACCTCATTA -> TCTAACCTTTTCGTACCTCATTAC
TGATACAGTATCCTATATCACGAG -> GATACAGTATCCTATATCACGAGT
GAAGGATATGCGGAAAGCTCAAGA -> AAGGATATGCGGAAAGCTCAAGAA
ACTACCTATATTACTGACACATGC -> CTACCTATATTACTGACACATGCC
CTGAACAGTGGCTCGGAATTTGAA -> TGAACAGTGGCTCGGAATTTGAAA
TGACCCGGGTGTTACTAGCGCAAC -> GACCCGGGTGTTACTAGCGCAACT
GGGGGATCTTCCTGAATCACCTCA -> GGGGATCTTCCTGAATCACCTCAC
CTTTATCATCTGGTCCCCAAGCCC -> TTTATCATCTGGTCCCCAAGCCCT
CGGAGAAAAACAGGAGTGACTGTC -> GGAGAAAAACAGGAGTGACTGTCT
GATTGTTCCAATACGTTCTTCGTC -> ATTGTTCCAATACGTTCTTCGTCC
TTCCGCCAGAAAAGCCTAAATCAC -> TCCGCCAGAAAAGCCTAAATCACA
CCTTGGTCCGTTCTACTATACATG -> CTTGGTCCGTTCTACTATACATGA
GACTCTCGAAGGATATGCGGAAAG -> ACTCTCGAAGGATATGCGGAAAGC
ATGGTGGCACATTTTAACGCATCC -> TGGTGGCACATTTTAACGCATCCC
AACATGCTGGACATTTTAATATCA -> ACATGCTGGACATTTTAATATCAG
CATATGTACGGAGAAAAACAGGAG -> ATATGTACGGAGAAAAACAGGAGT
ATAGGTTATCACTCCTACCCCCAT -> TAGGTTATCACTCCTACCCCCATC
ATCCAATGTATACGACTACCTATA -> TCCAATGTATACGACTACCTATAT
GCGGTGGCGAGCGGTAAACAGAAC -> CGGTGGCGAGCGGTAAACAGAACT
AGTGGGACGCTCACAGCAGTATGG -> GTGGGACGCTCACAGCAGTATGGG
TCGTAACCGTGGTCTGTACCCGAG -> CGTAACCGTGGTCTGTACCCGAGT
TTCCTCCACCACAGAAAACTAGAA -> TCCTCCACCACAGAAAACTAGAAG
TGGCTGCGCGCGTTCGAACGTCTA -> GGCTGCGCGCGTTCGAACGTCTAC
CCGTTTGTACTCTTAAATGGGTGA -> CGTTTGTACTCTTAAATGGGTGAG
TTTCTTAAATAGACATGGTACCGC -> TTCTTAAATAGACATGGTACCGCT
GGAAACTGTTAACCGTATAATTAG -> GAAACTGTTAACCGTATAATTAGT
AGGACGGACATTGAACTGCCTTTC -> GGACGGACATTGAACTGCCTTTCA
TTGTAGGCGTACCTGTCCCGTCGG -> TGTAGGCGTACCTGTCCCGTCGGC
CTACCTTGGTCCGTTCTACTATAC -> TACCTTGGTCCGTTCTACTATACA
ATGATTGGTCCTGACGTGCTGAAC -> TGATTGGTCCTGACGTGCTGAACC
TAGTCCGGGCGAATACATACCTTG -> AGTCCGGGCGAATACATACCTTGG
TAACCGTATAATTAGTTCTGTCTT -> AACCGTATAATTAGTTCTGTCTTA
Output
GAGGTAAAGGACGGACATTGAACTGCCTTTCACATCAAAAATCTTTCTTAAATAGACATGGTACCGCTTTATCATCTGGTCCCCAAGCCCTCAGGCTCTATGATTCCCAGGTCAACCATGCCTTCTCAGGGTCTGGAACATGCTGGACATTTTAATATCAGATGGTGGCACATTTTAACGCATCCCCAAAGGCTGAACAGTGGCTCGGAATTTGAAAACGTCTGAACCCATAGGTTATCACTCCTACCCCCATCCAAACCAAGGTCATACAAAGAAGGGGAGCACAGCTATTGTTTCTTTAGTGTGACCCGGGTGTTACTAGCGCAACTTCGAGTAACATCACAAGAACTCCCTCTTCAATTTTATTACTTGCCTTAGCTACCTTGGTCCGTTCTACTATACATGATGCATCTTATCGTAACCGTGGTCTGTACCCGAGTGAAACGGCAGCAGCGACTCCCTACAGCGGCGTCGCAAGAATCTCGTTTCCCTTTGAAAGGGCCGCAAGACGGCGCTTATGTCCCGCGTCTCTTATGCTCACCAGATTGTTCCAATACGTTCTTCGTCCCATATTCATATGCTTGCTGAAATATTCCTGGTGAGCCACGGCCGGCCATCCAATGTATACGACTACCTATATTACTGACACATGCCAACCTTGCTACAGCATTCCGCTTGTAAAAGCATGATCTCTGCCCGTTTGTACTCTTAAATGGGTGAGTTCATTGTAGGCGTACCTGTCCCGTCGGCAACCATGGGAAACTGTTAACCGTATAATTAGTTCTGTCTTATTATGCTCTCGCTTACTTAACGTAACGAATAGTCCGGGCGAATACATACCTTGGCCTTTGTACTCACCCTCGCAATTAGGATCTGGACCGCAATCAAGCGGTGGCGAGCGGTAAACAGAACTAAGAGACGTGCCACATTTCATATATGCGGGTGCCCGGCCGCACCACGGACTATAAGGATAACGAGGCGTGTATTCCTCCACCACAGAAAACTAGAAGAGGCCCTTCTATCCAGTTGTGTCCCTAATTCCGCCAGAAAAGCCTAAATCACACTGGGGGGATCTTCCTGAATCACCTCACTATTAGCCTGAGTGGGACGCTCACAGCAGTATGGGTGTATCGTGCAGAAAGGGATCTAACCTTTTCGTACCTCATTACACACGGGTCGGAGCCAAGCGCACAGTGGCTGCGCGCGTTCGAACGTCTACGGCCATGCTTCGGTCGCATACTCATATGTACGGAGAAAAACAGGAGTGACTGTCTATGATTGGTCCTGACGTGCTGAACCGTTAACGACGGCGGCGCCCTACCTGGATATTGGACCGTACCCCGACAGAGTGCTTCCCTCTGTCAAGAAATCAATCGGAAGAACGGCTGAACCTATATTCAGGCGGTTGTCTAGATGGTTGATACAGTATCCTATATCACGAGTGACAGGATTGGTTCAAAAATAGAATACCCCACATACGGTTTACAGGGCCTAAGGCTATCGAAAACAAGCAAGGCCGGGTTACCTGGTCCCAGAATACTAAATGTTAACAGTAGACTCTCGAAGGATATGCGGAAAGCTCAAGAATCCCGTCCTAGGTTG
